"","Date","Real GDP per capita (millions of chained 2012 dollars per person)","Electricity Sale to Residential Consumers per capita (MJ/person)","Natural Gas Deliveries to Residential Consumers per capita (MJ/person)","HDD","CDD","DD"
"1","1990-01",0.0283346641620893,1847.43411149177,2916.91442848653,497,0,-497
"2","1990-02",0.028330519768331,1185.77905594521,1738.10702081315,320,5,-315
"3","1990-03",0.0283293310629974,1253.53760964608,1405.85298900495,259,12,-247
"4","1990-04",0.0283240897349636,1149.21820607658,1107.74540677843,176,35,-141
"5","1990-05",0.0283260853249967,1249.73517820307,709.939674431605,35,144,109
"6","1990-06",0.0283307559281039,1653.72819992526,433.858432785118,0,371,371
"7","1990-07",0.0283398242764252,2110.90448982894,376.420270400587,0,439,439
"8","1990-08",0.0283521830453093,2072.04188055109,355.568189921665,0,490,490
"9","1990-09",0.0283685955863247,2016.31667305112,361.10171632309,17,346,329
"10","1990-10",0.0283898516867521,1358.50063462123,406.793667756729,143,92,-51
"11","1990-11",0.028420587640666,1143.66354794316,893.239551688669,272,6,-266
"12","1990-12",0.028456386795193,1381.62030857684,1422.48540959904,479,4,-475
"13","1991-01",0.0284981780289876,1672.93602168581,1937.41852451019,629,0,-629
"14","1991-02",0.0285439990565945,1421.00873837035,2208.42430244633,446,0,-446
"15","1991-03",0.0285975913772487,1308.14596276743,1781.86547686448,302,23,-279
"16","1991-04",0.0286544889432538,1177.17666475136,1030.18098133492,61,66,5
"17","1991-05",0.0287134760028574,1278.62053594281,544.562500577263,9,250,241
"18","1991-06",0.0287742788638553,1749.34558602121,418.159507232182,0,347,347
"19","1991-07",0.0288490165690055,2070.12950123176,378.437137811419,0,478,478
"20","1991-08",0.0289280920482704,2253.16836226577,360.647923777365,0,434,434
"21","1991-09",0.0290129187587445,1805.51985702839,365.799610425454,17,294,277
"22","1991-10",0.0291052944048518,1264.68060785618,471.718660969647,106,77,-29
"23","1991-11",0.0292064374710579,1234.07468749981,1021.41844427392,468,5,-463
"24","1991-12",0.0293171924159773,1501.40682825121,1679.79483715233,506,8,-498
"25","1992-01",0.02943451579951,1764.9561022046,2303.26711499129,678,0,-678
"26","1992-02",0.0295391356837562,1452.9258166814,2429.91671637696,438,0,-438
"27","1992-03",0.0296286765770565,1272.83764406796,1468.41951980124,349,3,-346
"28","1992-04",0.0297016659184858,1282.09502083909,1311.76021953882,172,47,-125
"29","1992-05",0.029760796238987,1268.61899746272,709.590487237186,47,117,70
"30","1992-06",0.0298052989376421,1594.45562340416,462.796647459716,1,277,276
"31","1992-07",0.0298362005798491,2160.46694607956,371.234546286685,0,442,442
"32","1992-08",0.0298509648874964,1926.7531007358,341.597075491454,0,319,319
"33","1992-09",0.0298538278184996,1650.93459602387,357.323803633778,5,241,236
"34","1992-10",0.0298437802124324,1206.91042569562,449.171038989621,130,8,-122
"35","1992-11",0.0298224639916817,1180.36628280821,883.280810914187,408,6,-402
"36","1992-12",0.0297896499199545,1621.79684197765,1883.09981934953,601,0,-601
"37","1993-01",0.0297433346623383,1603.58328528449,2100.85607778554,551,0,-551
"38","1993-02",0.0297124152580669,1402.05678896071,2119.10439502966,576,0,-576
"39","1993-03",0.029694948205296,1504.8823753296,2253.22472496838,453,2,-451
"40","1993-04",0.0296884472148804,1200.22034942597,1463.74997595362,216,7,-209
"41","1993-05",0.0296945323080693,1230.4276832664,734.74225361619,29,123,94
"42","1993-06",0.0297122635205847,1838.09404529687,422.918394934149,1,360,359
"43","1993-07",0.0297422171538902,2419.76368757582,368.163687880766,0,530,530
"44","1993-08",0.0297835030864468,2282.38854822916,341.547734574019,0,462,462
"45","1993-09",0.0298384800870637,1833.3497094191,341.727402502835,13,261,248
"46","1993-10",0.0299065822616908,1267.75791842357,391.72030560408,150,52,-98
"47","1993-11",0.0299901960919222,1238.28869495277,988.251361062807,429,13,-416
"48","1993-12",0.0300876495357492,1604.17976908095,1724.11414350442,650,0,-650
"49","1994-01",0.0301980358478419,2054.20841392931,2744.02949764872,799,0,-799
"50","1994-02",0.0303073426749619,1529.4021641553,2726.82288095772,462,2,-460
"51","1994-03",0.0304102855302785,1408.26703359183,1774.01987086144,330,6,-324
"52","1994-04",0.0305046434765223,1344.63076797679,1164.83835264983,110,81,-29
"53","1994-05",0.0305974250704993,1361.46760982101,564.03719750187,34,112,78
"54","1994-06",0.0306835113689283,1857.18694833851,393.631197879424,0,378,378
"55","1994-07",0.0307645120869653,2102.22212488927,347.181789873779,0,382,382
"56","1994-08",0.0308405465123457,2092.5917372083,337.24933556549,0,374,374
"57","1994-09",0.0309117754592621,2065.68150664922,337.520751135261,10,210,200
"58","1994-10",0.0309794957807688,1248.81598948973,380.5730783693,100,46,-54
"59","1994-11",0.0310450922993398,1136.48858708499,661.994644587645,245,5,-240
"60","1994-12",0.0311074466729399,1496.09938457254,1280.06723960274,500,0,-500
"61","1995-01",0.031166038550009,1839.04895581557,2119.18287971186,645,0,-645
"62","1995-02",0.0312271909905011,1525.66289183718,2337.19383828821,539,1,-538
"63","1995-03",0.0312901115703364,1366.49865056874,1926.29342620255,264,15,-249
"64","1995-04",0.0313516028570279,1138.35914963203,936.983755772595,127,51,-76
"65","1995-05",0.031416111103298,1493.5655891042,559.572626655462,29,219,190
"66","1995-06",0.0314798311207896,1949.50432620175,396.746511595928,2,294,292
"67","1995-07",0.0315438787648564,2355.21572542461,354.950318694134,0,483,483
"68","1995-08",0.0316094076799908,2653.21825396304,328.903186436092,0,522,522
"69","1995-09",0.0316748176562701,1995.65402945254,323.620416293618,14,252,238
"70","1995-10",0.0317421057705724,1230.22299688973,389.906642711936,134,59,-75
"71","1995-11",0.0318147568179532,1218.37412165063,986.112493617324,505,2,-503
"72","1995-12",0.031891602023091,1767.5648273114,1910.43400296178,676,2,-674
"73","1996-01",0.03197173224952,2246.03209701417,2750.4731872817,719,0,-719
"74","1996-02",0.03205149963267,1827.66532327596,2832.37311608488,587,6,-581
"75","1996-03",0.0321294729408312,1492.81668884636,2031.09057438686,492,4,-488
"76","1996-04",0.0322050199174381,1376.63278126235,1593.80476089534,210,26,-184
"77","1996-05",0.0322808300999599,1573.07604508461,742.939863803143,23,244,221
"78","1996-06",0.032354660027025,2102.85199880565,370.755555572424,0,339,339
"79","1996-07",0.0324278863680702,2577.31075095952,325.985822989264,0,438,438
"80","1996-08",0.0324986647222934,2241.31391631276,308.66926406367,0,397,397
"81","1996-09",0.0325692741044537,1881.12967636209,332.10306775193,8,211,203
"82","1996-10",0.0326408200004921,1220.84957954116,413.809995079913,131,44,-87
"83","1996-11",0.0327123892316978,1246.58269023946,869.060700601302,410,6,-404
"84","1996-12",0.0327881933248483,1725.08674770401,1672.56968021438,537,2,-535
"85","1997-01",0.0328649711464162,1997.75976329146,2338.70328445868,651,1,-650
"86","1997-02",0.0329416969676762,1576.61088257433,2289.32077100884,439,2,-437
"87","1997-03",0.033016347193053,1327.90244115435,1339.49563226657,195,25,-170
"88","1997-04",0.0330876708061232,1224.75201580985,799.375471973706,220,9,-211
"89","1997-05",0.0331584032239264,1345.74104271623,662.956460387802,54,91,37
"90","1997-06",0.0332264146755375,1627.55335733676,402.561403809148,3,253,250
"91","1997-07",0.0332925054670433,2529.12391795392,349.267565012686,0,456,456
"92","1997-08",0.0333544161723934,2376.11903228587,310.253451529469,0,378,378
"93","1997-09",0.0334160556169142,2060.33373392953,312.98552036595,0,278,278
"94","1997-10",0.0334780884886914,1487.32117209366,359.110432565231,171,84,-87
"95","1997-11",0.033541477121195,1415.71323213076,991.013327715254,481,0,-481
"96","1997-12",0.0336062534573279,1772.19180914586,1977.57068005405,670,0,-670
"97","1998-01",0.0336693344518336,1911.15506701495,2409.18561662234,567,0,-567
"98","1998-02",0.0337416857321848,1672.71621148451,2291.64117601095,482,0,-482
"99","1998-03",0.0338200700187938,1578.00575861565,1860.55006378856,420,17,-403
"100","1998-04",0.0338998206407729,1303.59531881603,1138.69409008408,152,23,-129
"101","1998-05",0.0339849199771395,1613.9187406376,584.486431114724,12,255,243
"102","1998-06",0.034074720356737,2542.01743036362,345.98908282585,2,449,447
"103","1998-07",0.034169444457767,2886.09868785276,300.720255688117,0,502,502
"104","1998-08",0.0342679724079113,2520.90997882638,293.440222011054,0,459,459
"105","1998-09",0.034373019343445,2154.13043927347,296.612548897756,0,365,365
"106","1998-10",0.0344845007436252,1816.15204264839,327.342830034853,67,107,40
"107","1998-11",0.0346033789692126,1125.63703288742,612.073200039459,258,7,-251
"108","1998-12",0.0347306634401087,1484.42648645983,1103.12672094013,481,14,-467
"109","1999-01",0.0348628190909931,2263.96251692787,2237.66205837713,533,3,-530
"110","1999-02",0.0349866910894539,1264.27631320466,1529.07614378421,417,5,-412
"111","1999-03",0.0350963308456185,1630.18127268142,1586.61177970425,430,0,-430
"112","1999-04",0.0351878060795628,1431.5880056652,965.547730756714,79,114,35
"113","1999-05",0.0352642788281366,1658.7496080887,464.366169946854,14,138,124
"114","1999-06",0.0353251273057891,2036.8395991071,336.127781766861,0,337,337
"115","1999-07",0.0353711383158537,2683.27668769679,311.488508088568,0,482,482
"116","1999-08",0.0354018940607794,2908.37471170876,278.183552740595,0,531,531
"117","1999-09",0.0354190193847133,2136.71260169358,292.275968857695,12,260,248
"118","1999-10",0.0354224819677684,1357.86701660194,384.047890593998,119,64,-55
"119","1999-11",0.0354147194895379,1274.25306954434,754.010774429788,272,1,-271
"120","1999-12",0.0353949380850208,1639.97984897013,1410.5680209961,585,0,-585
"121","2000-01",0.0353598759994013,2091.84030881906,2120.41005904928,616,1,-615
"122","2000-02",0.0353288646796289,1885.55745813828,2370.93832941183,399,2,-397
"123","2000-03",0.0352971246463558,1375.63188721907,1170.32033027363,221,6,-215
"124","2000-04",0.0352611140361025,1322.05105389634,843.911957921675,175,13,-162
"125","2000-05",0.0352284083774241,1702.44979338847,563.257842477832,0,269,269
"126","2000-06",0.0351931317494936,2285.95443529843,335.344502914312,1,372,371
"127","2000-07",0.0351545837992584,2711.05739313509,302.029522541218,0,526,526
"128","2000-08",0.035116719042703,2588.66486333622,284.346371057066,0,507,507
"129","2000-09",0.0350771853804888,2168.20511193207,290.68665600496,12,274,262
"130","2000-10",0.0350375035296047,1441.83154800874,425.690185396063,92,89,-3
"131","2000-11",0.0349993254336453,1462.5335212348,726.299880017749,420,34,-386
"132","2000-12",0.0349603216791854,2213.86026869721,2099.53694134128,839,0,-839
"133","2001-01",0.0349233359718837,2629.90590849753,3261.95928227307,768,0,-768
"134","2001-02",0.0349010006805654,1700.86223688956,2173.88614362631,395,4,-391
"135","2001-03",0.0348912156277778,1547.59846126081,1419.57984664828,451,1,-450
"136","2001-04",0.0348934930841515,1521.20893269645,1158.48071263332,102,86,-16
"137","2001-05",0.0349097504414688,1569.2183055278,476.338660498655,4,172,168
"138","2001-06",0.0349376241221379,1985.81703846353,326.287365048245,0,323,323
"139","2001-07",0.0349792663634813,2510.21631011966,289.011680904787,0,453,453
"140","2001-08",0.0350333492959657,2477.04406906522,286.81034153325,0,423,423
"141","2001-09",0.0350999790085822,2061.24204881923,281.683253105734,28,240,212
"142","2001-10",0.0351868630534679,1436.48635898281,412.838594867495,178,41,-137
"143","2001-11",0.035284421773108,1377.15647090612,744.017048260864,206,15,-191
"144","2001-12",0.0353970354807172,1604.10298235564,1081.38259566176,472,0,-472
"145","2002-01",0.0355249437176292,2391.41687976024,2261.61235589734,589,3,-586
"146","2002-02",0.0356421967459995,1591.51505820958,1930.14125279529,561,0,-561
"147","2002-03",0.0357508286336484,1805.4635721785,1777.0535536206,362,28,-334
"148","2002-04",0.0358466467711996,1444.21660357442,842.277468546154,75,102,27
"149","2002-05",0.0359304970734337,1757.26777360335,407.9706884393,42,186,144
"150","2002-06",0.0360020722011174,2132.53357183374,349.361769369522,0,364,364
"151","2002-07",0.0360640923385189,2657.80903456239,277.753400449579,0,479,479
"152","2002-08",0.0361144241786295,2693.72193161323,270.886249153936,0,476,476
"153","2002-09",0.0361530631766197,2353.81958427609,272.698723386432,0,368,368
"154","2002-10",0.0361822129170222,1801.7711483609,295.498768183012,62,132,70
"155","2002-11",0.0362025818831074,1415.236333628,696.85923168342,437,6,-431
"156","2002-12",0.0362159808016473,2120.32814688815,1848.13871152299,642,0,-642
"157","2003-01",0.0362190336004295,2455.51940130756,2537.18268423779,811,0,-811
"158","2003-02",0.0362487068948499,2057.93485696535,2462.0332972644,512,0,-512
"159","2003-03",0.0363003161763826,1628.52064002586,1454.48375715774,266,6,-260
"160","2003-04",0.0363717436737387,1384.378768042,783.455265756863,106,51,-55
"161","2003-05",0.0364631990068802,1738.65911303318,459.660633472668,2,195,193
"162","2003-06",0.0365658908675974,1945.59205947451,316.95757556816,0,304,304
"163","2003-07",0.0366875752155726,2543.5116737215,281.183457313214,0,415,415
"164","2003-08",0.0368308089762506,2565.1430156193,269.973802450843,0,454,454
"165","2003-09",0.0369968493963197,2306.24996749077,268.160292227334,14,263,249
"166","2003-10",0.0371844705863951,1510.319482546,348.732840127293,94,40,-54
"167","2003-11",0.0373946255936451,1367.75712984395,518.314875221102,248,28,-220
"168","2003-12",0.0376295646272719,2079.31175559645,1509.08316694241,678,0,-678
"169","2004-01",0.0378870532716478,2444.53650717831,2409.82527955224,676,2,-674
"170","2004-02",0.0381303303560928,2072.05695456797,2254.78620002539,607,0,-607
"171","2004-03",0.0383563351045759,1707.34757076554,1453.70870771369,220,13,-207
"172","2004-04",0.0385611402275353,1434.45761135923,790.084927803849,160,41,-119
"173","2004-05",0.0387473441129302,1798.83163390452,469.611550242078,24,266,242
"174","2004-06",0.0389189188311131,2309.65516852372,291.224494978811,0,349,349
"175","2004-07",0.0390728127692271,2645.06152207152,272.413964089247,0,440,440
"176","2004-08",0.0392084091692996,2482.36024053279,256.477313691422,0,353,353
"177","2004-09",0.0393275847539992,2053.54350790101,268.771086315959,1,265,264
"178","2004-10",0.0394290645904612,1647.65534346241,296.572442509646,34,128,94
"179","2004-11",0.0395176320172207,1434.88693034457,450.719982076133,268,28,-240
"180","2004-12",0.0395911970322972,1993.18351875739,1293.95688016059,871,0,-871
"181","2005-01",0.0396482445451533,2274.86979260967,1959.51170914971,522,1,-521
"182","2005-02",0.0397095237015579,1943.97414230079,1829.45543688771,427,1,-426
"183","2005-03",0.039765842173859,1768.49764502322,1409.88559697122,392,4,-388
"184","2005-04",0.0398153570407407,1474.04746748671,857.649391153158,138,15,-123
"185","2005-05",0.0398606188217074,1608.92946847704,482.765981404313,53,128,75
"186","2005-06",0.0399051157965703,2178.07656736438,312.312713785437,0,339,339
"187","2005-07",0.039945206400707,2695.89094972161,266.16712512942,0,472,472
"188","2005-08",0.0399829052624207,2722.69131523476,248.820616518902,0,480,480
"189","2005-09",0.040017012148216,2580.88028111756,250.462061723393,0,352,352
"190","2005-10",0.0400489656220644,1897.49497835138,269.383753745817,146,99,-47
"191","2005-11",0.0400843206683568,1477.49054216249,625.104200084966,310,22,-288
"192","2005-12",0.0401133621885954,2178.93397068625,1493.72830670099,713,0,-713
"193","2006-01",0.0401421532112344,2221.14536133859,1850.99756886035,439,2,-437
"194","2006-02",0.0401661215777968,1862.76094256557,1510.22407945117,547,0,-547
"195","2006-03",0.0401885521242994,1767.44523779528,1257.76594819086,314,21,-293
"196","2006-04",0.0402045018617677,1583.29601395227,707.728389186746,50,116,66
"197","2006-05",0.0402168360564668,1812.91727770227,314.494392270311,28,193,165
"198","2006-06",0.0402220430826471,2401.84382380609,269.550099219232,0,386,386
"199","2006-07",0.0402216645078658,2936.10195946106,231.50200357205,0,521,521
"200","2006-08",0.0402180343838064,2937.40931137506,213.008851250838,0,545,545
"201","2006-09",0.0402074321947701,2439.31495946815,213.997351127549,9,242,233
"202","2006-10",0.0401950208830069,1674.79934090251,286.442436373001,156,66,-90
"203","2006-11",0.0401797904049617,1566.96996200425,755.534236548234,368,3,-365
"204","2006-12",0.040157621200627,2067.19547122877,1357.99812940066,493,0,-493
"205","2007-01",0.0401340153349121,2137.28122984641,1423.14610608343,579,0,-579
"206","2007-02",0.040116011824594,2262.83079957533,1896.68204015273,586,0,-586
"207","2007-03",0.0401021651684106,1775.40615896831,1253.51924029117,197,31,-166
"208","2007-04",0.040088359711581,1490.90018557319,597.89991582941,192,41,-151
"209","2007-05",0.0400781350805223,1825.57991690578,422.371822496298,6,206,200
"210","2007-06",0.0400686003050915,2357.02606509481,252.404479880484,0,422,422
"211","2007-07",0.0400597907157624,2685.7404460319,217.739775554357,0,439,439
"212","2007-08",0.0400532981531894,3016.77801306196,203.831173559966,0,608,608
"213","2007-09",0.0400494383889322,2604.23828995355,205.283405179717,0,332,332
"214","2007-10",0.0400501473095265,1857.87136708481,229.965334585296,87,136,49
"215","2007-11",0.0400530400448508,1517.93367045511,520.329533119807,343,1,-342
"216","2007-12",0.0400601317750451,1915.37971217586,1049.25428336125,429,5,-424
"217","2008-01",0.0400724058413782,2398.46170461907,1634.52986857604,689,0,-689
"218","2008-02",0.0400636356433763,2102.97245026586,1708.7624044113,474,3,-471
"219","2008-03",0.0400323220574954,1753.50238758207,1231.6725662879,316,8,-308
"220","2008-04",0.0399812367869523,1465.34258039445,661.709396434604,118,50,-68
"221","2008-05",0.0399046823333137,1684.35346938259,361.609541990622,8,201,193
"222","2008-06",0.0398067866816425,2384.63111738483,241.324592916952,0,407,407
"223","2008-07",0.0396854998017597,2730.08042558943,210.267748998884,0,470,470
"224","2008-08",0.0395408733677457,2632.19805734308,198.164529663867,0,421,421
"225","2008-09",0.0393751758383889,2244.65553532177,205.919214196795,0,283,283
"226","2008-10",0.0391888754211245,1625.38857672236,240.65674084689,158,63,-95
"227","2008-11",0.0389816862922759,1583.16095838481,600.56584600525,435,3,-432
"228","2008-12",0.0387555367800483,2166.08306625605,1439.93863822277,500,4,-496
"229","2009-01",0.0385061392101307,2290.96734746839,1584.03413309906,634,1,-633
"230","2009-02",0.0382871484884972,2044.5651924447,1675.40291659661,480,1,-479
"231","2009-03",0.0380953108201753,1727.60914794723,1182.43648223789,272,11,-261
"232","2009-04",0.0379328735155255,1420.45389706318,600.462559245211,155,45,-110
"233","2009-05",0.0377971173071717,1723.74622192109,357.855213424111,12,199,187
"234","2009-06",0.0376886872732593,2225.1658222665,235.978728706065,0,428,428
"235","2009-07",0.0376074352605248,2769.04097663972,200.831830673465,0,404,404
"236","2009-08",0.0375538073227303,2512.3564380262,188.884855644691,0,408,408
"237","2009-09",0.0375258744182953,2075.43877097843,195.239013353443,6,302,296
"238","2009-10",0.0375266411349712,1617.59951376488,270.097920771068,147,70,-77
"239","2009-11",0.0375559240789666,1530.36669922758,556.111686315063,342,0,-342
"240","2009-12",0.0376162077673938,2138.80713376474,1232.42412266373,627,0,-627
"241","2010-01",0.0377018208206225,2839.58781607685,2090.98876855999,794,0,-794
"242","2010-02",0.0377843866164788,2367.7016629621,1760.32909320055,695,0,-695
"243","2010-03",0.0378643487320394,2018.59204340567,1497.10613006479,438,1,-437
"244","2010-04",0.0379401317729224,1433.28343293618,675.362200300286,70,36,-34
"245","2010-05",0.03801204429835,1739.13367951936,258.115625759329,12,259,247
"246","2010-06",0.0380803988858316,2493.59910165859,189.947713097518,0,472,472
"247","2010-07",0.038143054860777,2891.16922044616,165.212158165817,0,550,550
"248","2010-08",0.0382002916257419,2949.24976145306,159.4600946257,0,559,559
"249","2010-09",0.0382523581352945,2410.8936620119,148.112707606002,2,351,349
"250","2010-10",0.038300592413781,1609.07367982235,188.780736371174,87,57,-30
"251","2010-11",0.0383485657153904,1543.84900258191,620.273717228321,305,6,-299
"252","2010-12",0.0383936284405815,2433.93088561716,1793.27533568401,771,0,-771
"253","2011-01",0.0384334710541113,2636.92530646617,2239.5573188177,757,0,-757
"254","2011-02",0.0384723969911431,2098.90533486476,1421.62827795066,449,7,-442
"255","2011-03",0.0385086943425123,1588.59893728421,791.041395536314,271,17,-254
"256","2011-04",0.0385375589136715,1529.69507180359,437.336447354986,83,100,17
"257","2011-05",0.0385626914177041,1775.68579665511,306.963360044387,55,212,157
"258","2011-06",0.0385844738861617,2490.7966624874,190.081812230125,0,481,481
"259","2011-07",0.0385989542825253,2732.13815725772,136.013260141475,0,517,517
"260","2011-08",0.0386093503072333,2829.23484878722,173.813227944503,0,515,515
"261","2011-09",0.0386136208543533,2070.9558998638,191.768999905103,4,210,206
"262","2011-10",0.0386160963421375,1512.24812194328,344.49907196557,169,28,-141
"263","2011-11",0.038616631658086,1546.06424442906,770.678785096357,297,14,-283
"264","2011-12",0.0386132198855397,1948.49814024346,1229.37628698785,483,2,-481
"265","2012-01",0.0386053888864262,2021.44778967646,1325.2998197502,457,3,-454
"266","2012-02",0.0386076297423883,1721.71107901823,1008.75335859283,383,4,-379
"267","2012-03",0.0386123126516587,1526.12010089054,495.779416597408,99,77,-22
"268","2012-04",0.0386231810393118,1441.16686220922,298.228547198261,80,75,-5
"269","2012-05",0.0386401368146825,1824.92810469363,200.484462762406,3,265,262
"270","2012-06",0.0386603594127661,2205.30180333832,162.265867031424,0,371,371
"271","2012-07",0.0386852111473492,2675.6034537374,157.725054094114,0,519,519
"272","2012-08",0.0387135744353493,2447.61607192983,156.994440636922,0,412,412
"273","2012-09",0.0387459410535765,2034.72527652777,161.86550378408,7,249,242
"274","2012-10",0.0387854278082548,1510.20752209503,298.970815471447,129,45,-84
"275","2012-11",0.0388320318362542,1620.3506493833,836.843733738678,404,2,-402
"276","2012-12",0.0388858728438946,1878.08674065777,1086.20793205139,430,1,-429
"277","2013-01",0.0389464725430326,2112.33265556187,1376.73972179406,487,9,-478
"278","2013-02",0.0389979058363083,1860.21757839327,1266.89683777798,489,0,-489
"279","2013-03",0.0390351614512894,1889.90228844314,1165.53391416082,469,1,-468
"280","2013-04",0.0390579296061926,1502.57973684098,492.107741069774,130,49,-81
"281","2013-05",0.039069786075737,1595.20324447798,296.616735521548,52,159,107
"282","2013-06",0.0390640845217059,2155.26415620927,219.330029003145,0,393,393
"283","2013-07",0.039046947704392,2328.74821686047,159.986475199463,0,401,401
"284","2013-08",0.0390153319929716,2372.64378242474,172.247199101734,0,412,412
"285","2013-09",0.0389692019772612,2142.90785615427,173.981753858285,0,300,300
"286","2013-10",0.0389113381650936,1590.56862993321,255.30666313518,98,97,-1
"287","2013-11",0.0388413820198514,1655.88986101226,877.228689281753,408,6,-402
"288","2013-12",0.0387626269226631,2192.65053561207,1389.00331528617,547,11,-536
"289","2014-01",0.0386707428438238,2818.80551144488,2312.30586093011,848,0,-848
"290","2014-02",0.0385947634066665,2221.75215221475,1456.8701700705,512,1,-511
"291","2014-03",0.038533641205438,1814.17164970353,1029.86708083033,388,0,-388
"292","2014-04",0.0384854581607999,1444.46757155869,489.510417429498,94,42,-52
"293","2014-05",0.0384496291937646,1646.77108204204,300.304448969865,33,197,164
"294","2014-06",0.0384272261018986,2131.66820473741,179.476890299071,0,387,387
"295","2014-07",0.0384184199318742,2396.37156743453,170.512327525504,0,397,397
"296","2014-08",0.0384197836134649,2471.09962271312,166.89074277502,0,454,454
"297","2014-09",0.0384354839549929,2205.52131915766,159.704597348989,0,339,339
"298","2014-10",0.0384655355579702,1586.39180849046,250.639934422006,86,100,14
"299","2014-11",0.0385109234774022,1767.13081229457,993.626560958129,488,2,-486
"300","2014-12",0.0385726881660363,1989.57175121122,1197.630384526,468,1,-467
"301","2015-01",0.038649176588127,2414.24268337289,1802.30790972514,660,0,-660
"302","2015-02",0.038721301548624,2300.10395974299,1905.84170533516,682,0,-682
"303","2015-03",0.0387836998266631,1842.39603626268,860.801744010764,248,18,-230
"304","2015-04",0.0388364293418408,1386.03294704243,378.095915792165,60,80,20
"305","2015-05",0.0388803180241395,1662.84375644767,247.941213766477,12,224,212
"306","2015-06",0.0389156170001599,2215.65475616791,170.38952752081,0,422,422
"307","2015-07",0.0389411435002142,2648.17829797826,160.555764411881,0,526,526
"308","2015-08",0.0389570310809202,2532.09148587087,157.176369074962,0,436,436
"309","2015-09",0.0389647900260921,2025.11238695795,158.249953379695,2,289,287
"310","2015-10",0.0389638101377082,1513.21169134326,212.946263735353,69,73,4
"311","2015-11",0.0389583553158228,1455.29532869667,463.194110519107,205,37,-168
"312","2015-12",0.0389434890750061,1686.47462954887,777.612058009824,279,32,-247
"313","2016-01",0.0389255085905127,2284.79155550232,1600.24637324951,680,0,-680
"314","2016-02",0.0389160019479104,1956.77604183386,1226.72988653701,451,1,-450
"315","2016-03",0.0389134301270132,1546.78926810906,612.635159804106,199,31,-168
"316","2016-04",0.0389181088554511,1368.55043993515,365.756777493103,89,53,-36
"317","2016-05",0.0389300795008793,1630.77135677883,217.421525289843,22,186,164
"318","2016-06",0.0389498035790766,2223.32119079478,185.157845748191,0,437,437
"319","2016-07",0.0389756750173402,2701.80182219662,150.007408372536,0,537,537
"320","2016-08",0.0390093754457259,2642.4271998453,143.53257398284,0,520,520
"321","2016-09",0.0390509394341842,2349.00647945871,137.726120921725,0,442,442
"322","2016-10",0.0390997445042026,1677.23985999471,194.325660504989,19,197,178
"323","2016-11",0.039159612564111,1452.07979885905,397.471407199513,230,25,-205
"324","2016-12",0.0392291601999877,1908.61115872673,1083.4810230592,465,5,-460
"325","2017-01",0.0393058743631753,1993.52529925211,1079.77610830328,390,6,-384
"326","2017-02",0.0393779426898109,1524.9737853853,719.197907764482,268,5,-263
"327","2017-03",0.0394400780295752,1573.95320928586,707.318396536643,251,40,-211
"328","2017-04",0.0394928428110445,1512.19463585727,303.099772177393,47,121,74
"329","2017-05",0.0395351219815243,1672.51642350288,205.847336776839,23,189,166
"330","2017-06",0.0395678942895148,2015.8536328326,158.760993507886,0,340,340
"331","2017-07",0.0395899614630403,2533.13491057847,150.484598356839,0,493,493
"332","2017-08",0.0396020865532709,2427.05628358433,145.306126625567,0,436,436
"333","2017-09",0.0396052889328581,1969.22911869104,164.033858045499,9,268,259
"334","2017-10",0.0395996331395225,1696.45020116847,263.917940368992,114,147,33
"335","2017-11",0.0395871585479428,1541.84975560105,585.851721507976,295,25,-270
"336","2017-12",0.0395673204620277,2054.64947441726,1372.1790820582,563,4,-559
