"","Date","Real GDP per capita (millions of chained 2012 dollars per person)","Electricity Sale to Residential Consumers per capita (MJ/person)","Natural Gas Deliveries to Residential Consumers per capita (MJ/person)","HDD","CDD","DD"
"1","1990-01",0.0294766300561248,1385.25538134889,1789.419640506,528,0,-528
"2","1990-02",0.0294094413580403,1271.59808780588,1663.00378888979,429,3,-426
"3","1990-03",0.02933385367428,1082.07028101317,1199.57487798456,210,38,-172
"4","1990-04",0.0292172647818892,880.15665000238,651.000901058384,49,126,77
"5","1990-05",0.0291126073968783,952.093738352498,421.709841430483,15,252,237
"6","1990-06",0.0289986495362247,1294.58139237048,337.433567407356,0,611,611
"7","1990-07",0.0288834227708322,1782.45506328665,273.652706642924,0,659,659
"8","1990-08",0.0287619133456406,1648.15988025053,250.951484469523,0,556,556
"9","1990-09",0.0286376942526436,1583.4865738847,270.797720249857,0,469,469
"10","1990-10",0.0285143787322413,1102.25962902401,304.620826401181,37,188,151
"11","1990-11",0.0284126612161439,901.683220852899,498.607048391096,226,18,-208
"12","1990-12",0.0283126247972033,1161.58877988385,1302.20583874577,589,0,-589
"13","1991-01",0.0282184022637367,1465.77462639604,1828.42395560964,511,0,-511
"14","1991-02",0.0281483728670881,1111.6644652752,1328.029405234,223,1,-222
"15","1991-03",0.0281191417269824,1014.99667899318,1166.76897994815,376,0,-376
"16","1991-04",0.028111145929355,975.434862243469,931.861775944227,103,36,-67
"17","1991-05",0.0281191811561522,902.078764937908,468.614484454048,29,210,181
"18","1991-06",0.0281421332591647,1151.82645421076,348.637081745219,4,413,409
"19","1991-07",0.0282326236532208,1565.82993667804,299.867607958869,0,658,658
"20","1991-08",0.028348742511579,1741.24089485741,247.462324584943,0,654,654
"21","1991-09",0.0284964938787185,1590.82756303061,257.695916140997,0,458,458
"22","1991-10",0.0286835359764157,1266.74005608564,307.601676623999,71,296,225
"23","1991-11",0.0289150536331897,957.709767373862,540.027803908152,266,18,-248
"24","1991-12",0.029194701467567,1217.32565735691,1326.72317042566,459,0,-459
"25","1992-01",0.0295090988485473,1335.23964375423,1589.46651911041,509,0,-509
"26","1992-02",0.0297966275406565,1127.07827389159,1196.11907925511,293,0,-293
"27","1992-03",0.0300468255636757,1005.5393632822,1015.24511381049,234,1,-233
"28","1992-04",0.0302531103577543,874.36501470584,652.688932475453,50,147,97
"29","1992-05",0.0304275489784281,1118.31134888394,339.736361679098,8,318,310
"30","1992-06",0.030566801898409,1290.87814484395,317.765118395967,0,478,478
"31","1992-07",0.0306755914216727,1611.37250303369,265.106448545221,0,637,637
"32","1992-08",0.0307426520504175,1734.5295227771,227.437252879221,0,624,624
"33","1992-09",0.0307871599212938,1520.8607582133,242.073914350965,0,492,492
"34","1992-10",0.0308047214683158,1250.4683125749,277.446127382588,20,212,192
"35","1992-11",0.0308028333531037,917.003921404577,436.12620860873,364,0,-364
"36","1992-12",0.0307805738669744,1315.95765159701,1413.00877662719,562,0,-562
"37","1993-01",0.0307290724031736,1344.88899866821,1515.98539851891,420,0,-420
"38","1993-02",0.0307104351605772,1094.88779888279,1132.36514718943,366,0,-366
"39","1993-03",0.0307161354675863,1005.72572273779,1118.38624858844,205,10,-195
"40","1993-04",0.0307352094333185,850.879949728473,595.782710477961,72,93,21
"41","1993-05",0.0307750127764462,1031.76593245257,353.828178068524,11,339,328
"42","1993-06",0.0308314273952795,1341.28006757566,298.375814481622,4,504,500
"43","1993-07",0.0309070710712178,1746.31029241883,225.583631168921,0,631,631
"44","1993-08",0.030997989447393,1734.93034611286,216.428891374175,0,619,619
"45","1993-09",0.0311146679859097,1576.00173724228,229.964784376847,3,440,437
"46","1993-10",0.0312545261224413,1193.9779819369,265.137295169421,50,186,136
"47","1993-11",0.0314281012357561,922.149901805512,494.117340200709,305,0,-305
"48","1993-12",0.0316278524555753,1210.41073891662,1217.82428848845,488,0,-488
"49","1994-01",0.0318496159338204,1345.27027197999,1505.78355394351,459,0,-459
"50","1994-02",0.032072213004421,1233.6381195032,1367.9296673137,399,0,-399
"51","1994-03",0.0322721235526492,988.723218995048,967.583772370619,167,14,-153
"52","1994-04",0.0324394666962899,939.963726484691,564.462585802143,83,126,43
"53","1994-05",0.0326056097792564,959.144247487739,379.085746876132,15,252,237
"54","1994-06",0.0327477573543274,1350.66571844459,292.179904372618,0,639,639
"55","1994-07",0.0328731704448162,1900.45268675748,234.539760262729,0,725,725
"56","1994-08",0.0329824546242215,1982.33638480779,209.519661516387,0,744,744
"57","1994-09",0.0330763982131571,1827.8974146871,220.406044487199,0,504,504
"58","1994-10",0.0331608049054491,1148.35253766532,271.751651708721,61,140,79
"59","1994-11",0.0332418033777742,896.446760937158,520.628420773081,359,3,-356
"60","1994-12",0.0333144440634877,1226.98454043403,1248.4965096572,446,0,-446
"61","1995-01",0.0333764421749697,1301.36963009649,1413.86013761473,478,0,-478
"62","1995-02",0.033452472520189,1084.25935221506,1166.38205493344,196,2,-194
"63","1995-03",0.0335389441492016,936.75750417496,723.422702299389,210,17,-193
"64","1995-04",0.0336218097889291,897.467732331825,615.286916068656,135,67,-68
"65","1995-05",0.0337204073276711,937.304894066165,460.941512233419,45,192,147
"66","1995-06",0.033818070434401,1188.21945139915,314.436890491739,4,454,450
"67","1995-07",0.0339196027988826,1697.27655908361,243.393864834981,0,714,714
"68","1995-08",0.0340299436217906,2034.97573966932,215.119152741196,0,741,741
"69","1995-09",0.0341420792069508,1861.65827997059,219.192075163796,1,541,540
"70","1995-10",0.0342645953374276,1221.17676256623,255.622871107969,28,214,186
"71","1995-11",0.0344124918415766,921.268354283946,385.854198713912,105,23,-82
"72","1995-12",0.0345806536894321,984.63986758095,781.545226947424,400,0,-400
"73","1996-01",0.034765123161869,1289.35936816664,1346.40812637665,435,0,-435
"74","1996-02",0.0349432498842435,1087.7182576543,1042.31341581486,223,10,-213
"75","1996-03",0.0351088059036137,991.477895530718,829.588845504692,186,19,-167
"76","1996-04",0.0352590240145257,913.704143482317,529.968092937204,46,136,90
"77","1996-05",0.0354055966116852,1146.49552387026,325.901545497368,4,371,367
"78","1996-06",0.0355387658168777,1437.066396514,266.633234142091,0,607,607
"79","1996-07",0.0356645230046215,1943.55160964364,223.751287378108,0,759,759
"80","1996-08",0.0357748603832161,2031.16830799776,203.679855835876,0,709,709
"81","1996-09",0.03587969370587,1796.47143629079,218.707977881546,7,402,395
"82","1996-10",0.0359838117210942,1284.24070504558,262.29828612109,122,246,124
"83","1996-11",0.0360832420150381,965.865652897044,561.556373181716,195,15,-180
"84","1996-12",0.0361961811992631,1143.72335947381,977.892168282765,429,0,-429
"85","1997-01",0.0363084784456581,1333.939871892,1435.78574475054,456,0,-456
"86","1997-02",0.0364317430098191,1160.71577231333,1220.98389423281,354,0,-354
"87","1997-03",0.0365571520425367,1044.1810765664,1013.66352079401,134,69,-65
"88","1997-04",0.0366792309735217,937.694263315039,539.404991687532,119,109,-10
"89","1997-05",0.0368097285531771,1199.13592268738,374.446180219412,3,448,445
"90","1997-06",0.0369393798200034,1498.56288130657,274.310637703081,1,484,483
"91","1997-07",0.0370715786953204,1757.26988985053,241.484176946269,0,691,691
"92","1997-08",0.0371965179422936,1956.06253835938,215.142129042851,0,709,709
"93","1997-09",0.0373310076770718,1923.61234334998,265.825159752972,0,558,558
"94","1997-10",0.0374778529748787,1427.31171786284,248.324189005966,80,182,102
"95","1997-11",0.0376411577297713,934.407040311883,464.061494006121,213,17,-196
"96","1997-12",0.0378210407051367,1176.14603941213,1117.83008992545,570,0,-570
"97","1998-01",0.0380041740293987,1444.76883325437,1674.84574103065,425,0,-425
"98","1998-02",0.0382122273604293,1220.39397850449,1318.95755283483,441,0,-441
"99","1998-03",0.0384313050842261,1159.98017843167,1250.62080897105,280,11,-269
"100","1998-04",0.0386411539617838,957.135577581977,866.518622809344,196,56,-140
"101","1998-05",0.038859042477212,1019.47740865606,489.730719309552,30,191,161
"102","1998-06",0.0390821172007753,1282.16844585612,321.432136667517,2,421,419
"103","1998-07",0.0393112813631999,2029.35057150881,247.990193307111,0,733,733
"104","1998-08",0.0395415255988787,2197.64769667271,208.774217157514,0,710,710
"105","1998-09",0.0397846217255105,1930.89697354888,217.347460825797,0,505,505
"106","1998-10",0.0400400790685732,1250.92166822046,262.476510714081,48,148,100
"107","1998-11",0.0403119997419403,923.223985441626,463.801322244784,223,0,-223
"108","1998-12",0.0406047174258739,1247.86159113134,1077.91091006263,476,0,-476
"109","1999-01",0.0409023779236741,1404.7780751839,1474.70649493638,414,0,-414
"110","1999-02",0.0411790097831461,1154.29652532289,1262.78588906818,287,0,-287
"111","1999-03",0.0414077068483799,1047.4393498063,862.226386887331,172,8,-164
"112","1999-04",0.0415705971002816,996.753285930594,777.117952009477,195,66,-129
"113","1999-05",0.04168181981506,1075.72184328641,483.946163991385,22,281,259
"114","1999-06",0.0417389018067596,1557.55198978896,309.51359553684,3,519,516
"115","1999-07",0.0417459099977252,2053.14670803628,242.17989498714,0,638,638
"116","1999-08",0.0417018036042014,2127.03997666266,217.631936422438,0,655,655
"117","1999-09",0.0416147221511817,1847.40417525373,225.768957512465,1,495,494
"118","1999-10",0.0414856205170498,1421.72050616212,259.435702036368,24,257,233
"119","1999-11",0.0413261690294717,1016.18564173705,371.494259207982,139,59,-80
"120","1999-12",0.0411340705353127,1252.7604042603,1016.2695823829,480,0,-480
"121","2000-01",0.0408969500592922,1364.41688711229,1395.88692593512,383,0,-383
"122","2000-02",0.0407042843580382,1019.01202437243,1360.54091523381,271,0,-271
"123","2000-03",0.0405353447135187,1094.14960594729,894.429825024298,221,12,-209
"124","2000-04",0.0403752533931955,997.107448384996,564.094943525771,42,176,134
"125","2000-05",0.0402544504111872,1340.18532612234,317.920815595561,5,427,422
"126","2000-06",0.0401486399692411,1732.12203892269,246.657013783871,0,596,596
"127","2000-07",0.0400547994050579,2048.58778861531,207.504069700139,0,730,730
"128","2000-08",0.0399884614728639,2171.03011622231,187.350999457645,0,680,680
"129","2000-09",0.0399399512840255,1801.2173111594,200.754838591083,2,549,547
"130","2000-10",0.0399150690072816,1387.192173599,220.622540856565,78,162,84
"131","2000-11",0.0399201351853036,1069.48205026302,573.630049721579,425,0,-425
"132","2000-12",0.039945781231125,1256.50958230467,1172.76319801694,428,0,-428
"133","2001-01",0.0400031862771332,1408.96675794229,1391.20288727874,533,0,-533
"134","2001-02",0.0400570643910447,1222.54730202981,1459.59569790314,401,0,-401
"135","2001-03",0.0400987503712017,1153.74926859972,1121.92968114589,229,25,-204
"136","2001-04",0.040126012063526,957.817445860545,582.127344182743,121,111,-10
"137","2001-05",0.0401462300462138,1351.53314287032,390.40479039744,7,428,421
"138","2001-06",0.0401498398864678,1749.64370814898,260.427314437532,0,603,603
"139","2001-07",0.0401452473106316,2072.81418683483,216.651819016362,0,696,696
"140","2001-08",0.0401271215194625,2112.11620610369,201.112273201078,0,682,682
"141","2001-09",0.0400958783008687,1917.91782842646,209.176275212281,0,563,563
"142","2001-10",0.0400815668881085,1497.66438575916,234.753820886221,16,235,219
"143","2001-11",0.0400466843062919,1066.36596780875,336.255989487435,177,54,-123
"144","2001-12",0.0400083062314081,1267.50986337409,1013.4048933095,554,0,-554
"145","2002-01",0.0399672938757203,1441.70829401778,1518.63432755103,481,0,-481
"146","2002-02",0.0399479431254301,1209.17683390702,1343.23260570738,312,0,-312
"147","2002-03",0.0399576550963501,1093.73311566961,896.781685131183,250,12,-238
"148","2002-04",0.0399803119316437,1010.4940017791,525.963854509537,30,161,131
"149","2002-05",0.0400189343118946,1231.92837753822,335.714623446898,12,295,283
"150","2002-06",0.0400721719696266,1693.67899568638,269.570329438517,0,623,623
"151","2002-07",0.0401499486966695,2174.08108211043,213.729715004124,0,746,746
"152","2002-08",0.0402440570217202,2162.14826402487,201.11367035241,0,689,689
"153","2002-09",0.0403542485308316,1880.57540563754,211.849528018939,1,522,521
"154","2002-10",0.0404884804251086,1372.55907783586,249.153178047915,51,146,95
"155","2002-11",0.0406491696798408,984.781383701303,414.275662734391,184,6,-178
"156","2002-12",0.0408429099689256,1178.82572631675,863.724931601564,517,0,-517
"157","2003-01",0.0410569800054943,1303.91648442644,1378.20302882587,284,0,-284
"158","2003-02",0.0412700244128802,1036.22039222222,961.025613180298,332,0,-332
"159","2003-03",0.041464616445206,1078.58603727171,963.125877843972,232,11,-221
"160","2003-04",0.0416328232824439,944.22456771143,587.267172376877,116,60,-56
"161","2003-05",0.0417754895149178,1182.06592910809,406.991777485208,19,346,327
"162","2003-06",0.041859601131432,1770.65680646714,265.337843264296,0,557,557
"163","2003-07",0.0419147365341105,2248.08562148848,217.346563953649,0,804,804
"164","2003-08",0.0419507647063611,2294.10549126252,212.504065931824,0,725,725
"165","2003-09",0.0419725489448529,2043.73608706466,202.701443016343,0,551,551
"166","2003-10",0.0419756713204164,1579.9266130124,268.862314227884,7,347,340
"167","2003-11",0.0419637724458799,1091.62352835959,411.198345197507,263,5,-258
"168","2003-12",0.0419450489142566,1275.52596056719,1079.17818417189,455,0,-455
"169","2004-01",0.0419112839663895,1372.59623943324,1360.70071258517,438,0,-438
"170","2004-02",0.0419095592837169,1227.06921670646,1314.73999364936,443,0,-443
"171","2004-03",0.0419286616192701,1186.5602283769,921.13179859609,111,150,39
"172","2004-04",0.0419546572888144,1089.82327147991,435.105567828015,69,112,43
"173","2004-05",0.041996653823642,1358.07376581744,322.334458117768,2,362,360
"174","2004-06",0.0420682375789327,1785.18554952207,236.423140706738,0,558,558
"175","2004-07",0.042158474292556,2165.26560381438,212.051184929658,0,712,712
"176","2004-08",0.042264972854138,2241.14912422101,196.773820069104,0,660,660
"177","2004-09",0.0423938887861919,1910.77048707611,215.951256527435,4,487,483
"178","2004-10",0.0425405003384194,1350.67836645164,277.788710105839,66,177,111
"179","2004-11",0.0427208197371698,1036.21770213423,527.858274216459,297,8,-289
"180","2004-12",0.0429273178960947,1346.3358412714,1185.32048009224,1023,0,-1023
"181","2005-01",0.0431544592264477,1400.75632182887,1322.49672217606,433,0,-433
"182","2005-02",0.0433874842166349,1108.74632649541,1030.19763061528,362,0,-362
"183","2005-03",0.043595041847188,1060.09535742828,813.57299173919,272,3,-269
"184","2005-04",0.0437709284305598,1023.24002819048,553.525121919469,84,63,-21
"185","2005-05",0.0439240760266252,1313.91901746014,338.453545237192,17,324,307
"186","2005-06",0.0440666671137111,1893.3984353126,251.082720085603,1,489,488
"187","2005-07",0.0441863964480032,2410.46758313583,209.145616629685,0,743,743
"188","2005-08",0.0442904065574318,2297.00502002279,190.045921449156,0,607,607
"189","2005-09",0.044374814729925,2071.42257337343,205.771605725692,0,484,484
"190","2005-10",0.044444798406704,1481.16376321914,247.211123828211,35,192,157
"191","2005-11",0.0445195775481869,1036.1954920704,390.213978763876,210,20,-190
"192","2005-12",0.0445661843420102,1291.3575631397,958.637195152325,453,0,-453
"193","2006-01",0.0446055914313592,1342.69138600277,1107.6744841619,449,0,-449
"194","2006-02",0.0446419190831447,1115.26372143545,1014.41953031595,305,0,-305
"195","2006-03",0.0446864223974759,1112.79260047789,868.257868400514,329,0,-329
"196","2006-04",0.044722392113635,1069.52177804468,549.631674138458,73,45,-28
"197","2006-05",0.0447596351207556,1465.80349728172,310.805762560164,2,330,328
"198","2006-06",0.0447863330518527,2070.7245970577,235.473300060428,0,597,597
"199","2006-07",0.0448077838103468,2495.18301362505,198.293138292535,0,677,677
"200","2006-08",0.044831918150273,2369.4814211649,188.352646468586,0,553,553
"201","2006-09",0.0448462247699979,1957.44326315483,209.194358075679,5,327,322
"202","2006-10",0.0448681273787129,1394.73470312959,267.583845768198,64,113,49
"203","2006-11",0.0448942200379553,1079.05436394173,416.155920171571,194,11,-183
"204","2006-12",0.0449106600332977,1332.37947402548,961.471228390186,549,0,-549
"205","2007-01",0.0449359335711972,1567.42397050081,1550.4229217373,599,0,-599
"206","2007-02",0.0449573232892983,1226.94521724728,1226.92392938522,349,0,-349
"207","2007-03",0.044970061378534,1111.80230382476,772.481180152333,178,47,-131
"208","2007-04",0.0449604466774538,1056.4458209213,404.141701996554,90,77,-13
"209","2007-05",0.0449404558712043,1498.63165134339,314.253413034465,7,304,297
"210","2007-06",0.0449005350747977,1946.41231953627,236.090525185962,1,527,526
"211","2007-07",0.0448409609809063,2486.86531802804,195.978200565351,0,671,671
"212","2007-08",0.044767198779528,2412.95085169178,185.233012450279,0,642,642
"213","2007-09",0.0446804418209625,2283.25280746659,191.145336202321,2,435,433
"214","2007-10",0.0445872262777129,1447.04612283585,250.866269240196,30,143,113
"215","2007-11",0.0444797878227919,1121.93061797126,352.435448585258,146,30,-116
"216","2007-12",0.0443648997332965,1317.75831720199,865.822180630807,590,0,-590
"217","2008-01",0.04424587299808,1472.67312715273,1472.26966807863,555,0,-555
"218","2008-02",0.044092123879088,1288.29502374797,1263.78168630293,427,0,-427
"219","2008-03",0.0438988822974693,1113.1851840415,793.563736412683,229,7,-222
"220","2008-04",0.0436752775366337,1032.84596176212,451.697756378914,77,57,-20
"221","2008-05",0.0434031076418693,1282.96505809112,315.302531492411,34,167,133
"222","2008-06",0.0430959602341486,1826.63497213416,251.388410793214,0,538,538
"223","2008-07",0.0427475694159492,2368.0320830384,189.842908128358,0,619,619
"224","2008-08",0.0423584942168324,2355.92063390814,175.422730999523,0,589,589
"225","2008-09",0.0419362529321853,1991.67574875509,189.921996075919,0,431,431
"226","2008-10",0.0414826012051851,1431.05780973768,237.436142595948,39,167,128
"227","2008-11",0.0409969552784407,1053.01408036961,363.426969331137,193,14,-179
"228","2008-12",0.0404855150946503,1189.5972315045,726.247806149125,506,0,-506
"229","2009-01",0.0399355623792488,1321.67850563732,1171.31008899141,420,0,-420
"230","2009-02",0.0394683250998354,1054.57154971501,877.23124397095,349,0,-349
"231","2009-03",0.0390723556592306,1058.87571373964,609.102917411415,217,11,-206
"232","2009-04",0.038753132760825,966.932641936365,428.781961233387,131,60,-71
"233","2009-05",0.0385017902576839,1502.71567200823,283.642368198609,0,356,356
"234","2009-06",0.0383198349295932,1688.71864296827,221.906356485577,0,407,407
"235","2009-07",0.0382067832874256,2347.63440500382,188.541124743329,0,711,711
"236","2009-08",0.0381642711936591,2365.90625432171,170.294488882705,0,627,627
"237","2009-09",0.0381872565493871,1982.38669750757,183.949446897706,0,448,448
"238","2009-10",0.0382857238152473,1336.89095175323,242.464714232433,85,95,10
"239","2009-11",0.0384606822485685,1035.28635161225,411.325898717532,202,26,-176
"240","2009-12",0.0387217616222141,1260.89551796585,921.731724162575,585,0,-585
"241","2010-01",0.0390542366861105,1357.29289006079,1242.51549111506,489,0,-489
"242","2010-02",0.0393611227391652,1103.24588688662,1008.35299887919,402,0,-402
"243","2010-03",0.0396432017756322,1108.27009113212,869.031096994262,322,0,-322
"244","2010-04",0.0398948851886912,1021.68211376622,512.238080909542,148,31,-117
"245","2010-05",0.0401165273416148,1264.4685997526,333.822068924425,38,151,113
"246","2010-06",0.0403085886467656,1891.49480742198,240.541853390235,0,481,481
"247","2010-07",0.0404636213742731,2505.21522722088,190.41660797572,0,665,665
"248","2010-08",0.0405820557932172,2328.75055534029,175.578541701488,0,597,597
"249","2010-09",0.0406643502427988,2019.1849734797,189.671513615205,0,482,482
"250","2010-10",0.040714637734662,1378.10828454782,233.872667444113,44,160,116
"251","2010-11",0.0407444174906586,1033.20804755864,482.215771673929,327,13,-314
"252","2010-12",0.0407448812206466,1238.92973764165,893.849300302132,387,0,-387
"253","2011-01",0.040708443998436,1382.39838889497,1314.96612118685,508,0,-508
"254","2011-02",0.0406899995444947,1201.92889907962,1172.83112735962,477,0,-477
"255","2011-03",0.0406837255900834,1058.50780433027,694.549627323833,188,13,-175
"256","2011-04",0.040673980370555,1097.63850274054,416.874919101647,83,81,-2
"257","2011-05",0.0406725349749516,1280.01821088775,307.075788421724,36,153,117
"258","2011-06",0.0406804517767794,1838.56554690948,234.377803857867,0,478,478
"259","2011-07",0.0406849726141093,2395.7715655637,186.470720012957,0,634,634
"260","2011-08",0.0406962767659137,2487.9440253595,161.126187270313,0,699,699
"261","2011-09",0.0407077535720142,2000.00363669119,177.904520705021,0,471,471
"262","2011-10",0.0407330988268738,1324.51899849497,250.692605578311,36,178,142
"263","2011-11",0.0407717628378065,991.893538629127,472.759455209504,292,2,-290
"264","2011-12",0.0408173010864649,1351.89590622664,1089.13166680211,585,0,-585
"265","2012-01",0.0408681680741189,1301.65828359785,1231.25933383168,409,0,-409
"266","2012-02",0.0409263750750485,1052.65583360801,981.949581546786,374,0,-374
"267","2012-03",0.0409676000842785,1049.78902110999,745.12663438832,259,7,-252
"268","2012-04",0.0410038031393688,1112.18430738538,433.473287584777,82,108,26
"269","2012-05",0.0410346813012883,1508.5727393757,274.648729222594,3,305,302
"270","2012-06",0.041051227751011,2051.54118898662,214.601441767845,0,562,562
"271","2012-07",0.0410578060487509,2276.12368631072,181.460719008863,0,601,601
"272","2012-08",0.0410508680689366,2365.09710809712,168.696995671391,0,637,637
"273","2012-09",0.0410320117942343,1862.19518372183,179.561976257193,0,430,430
"274","2012-10",0.0410111536556172,1315.54359339415,226.558455832321,18,169,151
"275","2012-11",0.0409882433403597,1005.99415357198,398.435347180292,161,19,-142
"276","2012-12",0.0409636042798503,1208.06999805151,760.270868003244,498,0,-498
"277","2013-01",0.0409356613892705,1467.69549607715,1532.66260995779,595,0,-595
"278","2013-02",0.0409211868981375,1130.33210309902,1159.77068066002,468,0,-468
"279","2013-03",0.0409043387635991,1059.69513884362,790.465067374612,166,18,-148
"280","2013-04",0.0408841031357666,1072.64885073518,373.30611451879,74,71,-3
"281","2013-05",0.0408715989095009,1463.81913914539,274.895514463757,6,256,250
"282","2013-06",0.0408459915986596,2076.49179614157,201.146574373271,0,572,572
"283","2013-07",0.0408263303223257,2378.19711512094,172.441668704782,0,638,638
"284","2013-08",0.040803036125428,2215.17381113414,168.798291011172,0,624,624
"285","2013-09",0.0407759162898996,1812.00223998101,184.899593094617,2,406,404
"286","2013-10",0.0407535322074679,1118.14100033186,272.737523923178,63,78,15
"287","2013-11",0.040734666576992,956.105315412752,414.102975361111,218,8,-210
"288","2013-12",0.0407294841086871,1262.28340831458,962.391850312162,510,0,-510
"289","2014-01",0.0407244157881951,1242.13869626316,1135.06194922634,385,0,-385
"290","2014-02",0.0407284454162001,973.340488430018,788.064849321202,254,1,-253
"291","2014-03",0.040738268652904,965.569959448085,513.002820242448,163,2,-161
"292","2014-04",0.040747837002314,1040.08536371411,384.6179275472,87,62,-25
"293","2014-05",0.0407552616345603,1384.45652006795,283.329236777851,17,250,233
"294","2014-06",0.0407638471080004,1991.11882910713,206.190228541208,0,519,519
"295","2014-07",0.0407740826460129,2349.3183632405,177.035890079664,0,636,636
"296","2014-08",0.0407752113531132,2097.35202719009,165.326081719059,0,504,504
"297","2014-09",0.0407802371673495,1837.99627908648,180.874160475917,0,422,422
"298","2014-10",0.0407891601451388,1299.27688284552,222.5998000857,4,174,170
"299","2014-11",0.04080499363236,983.311458771276,398.682520333388,236,7,-229
"300","2014-12",0.0408308933296901,1195.39589191856,784.762563089288,459,0,-459
"301","2015-01",0.0408616373631554,1247.71800112651,1191.84039611267,438,0,-438
"302","2015-02",0.0409063866744747,906.317337112646,684.813839075108,210,0,-210
"303","2015-03",0.0409484402352183,1050.74218059782,512.173633385182,125,43,-82
"304","2015-04",0.0409879116940809,1041.20904168477,350.197229515702,82,41,-41
"305","2015-05",0.0410272805578711,1227.2364133443,290.72852621495,43,137,94
"306","2015-06",0.0410672358794901,1986.94948745807,210.491747769854,0,546,546
"307","2015-07",0.0411040522421322,2234.44830882227,169.761294643465,0,575,575
"308","2015-08",0.0411380567379635,2330.96349668614,155.518225886808,0,649,649
"309","2015-09",0.0411737970263074,1861.85771671212,171.481014354296,0,446,446
"310","2015-10",0.0412092991557314,1346.24032623829,213.222322618041,28,184,156
"311","2015-11",0.0412575481091056,983.257879191485,496.172456907527,331,1,-330
"312","2015-12",0.0413032915033789,1330.29981248382,1053.97903819738,566,0,-566
"313","2016-01",0.0413657723702221,1320.04013259134,1376.83858820263,523,0,-523
"314","2016-02",0.0414319263138057,1024.0500081463,917.430912336675,236,1,-235
"315","2016-03",0.0414969439241767,970.821040567197,486.706268949719,149,14,-135
"316","2016-04",0.0415617174666262,1025.31597049083,381.153772105043,81,45,-36
"317","2016-05",0.0416262993973632,1311.58785305157,277.569381063011,21,177,156
"318","2016-06",0.0416920387442307,2100.12876011213,208.304433782854,0,573,573
"319","2016-07",0.041753921507711,2434.36599896213,169.449365632995,0,695,695
"320","2016-08",0.0418170589103506,2189.84907146833,161.381203932941,0,596,596
"321","2016-09",0.041881490357842,1670.18503678906,178.811003531456,0,405,405
"322","2016-10",0.0419452373456165,1346.21582018754,223.646377276932,0,208,208
"323","2016-11",0.0420199628528609,993.915385069442,360.523080975423,187,11,-176
"324","2016-12",0.0421013282004133,1165.35521655472,775.314086258291,436,0,-436
"325","2017-01",0.0421815473754364,1235.0409196004,1034.95458974829,510,0,-510
"326","2017-02",0.0422625799749031,954.902955957932,906.582629557873,293,0,-293
"327","2017-03",0.042328220585408,1053.061734536,574.473302959125,144,51,-93
"328","2017-04",0.0423801911718096,1092.32141960369,365.504934450564,60,77,17
"329","2017-05",0.0424150974945507,1409.14369613246,275.720470905027,31,229,198
"330","2017-06",0.0424359470018112,2115.93829239616,204.700483482319,0,582,582
"331","2017-07",0.0424391178597581,2382.47256328887,169.971720003841,0,644,644
"332","2017-08",0.0424269741431205,2203.68136803424,155.831540028237,0,591,591
"333","2017-09",0.0424026507323489,1774.25194813988,176.202667331783,4,388,384
"334","2017-10",0.0423663791036713,1305.49793277786,230.764737934193,10,194,184
"335","2017-11",0.0423243628051462,983.198514755169,327.216892035781,74,18,-56
"336","2017-12",0.0422749771095935,1119.03727868766,654.421007620758,395,0,-395
