"","Date","Real GDP per capita (millions of chained 2012 dollars per person)","Electricity Sale to Residential Consumers per capita (MJ/person)","Natural Gas Deliveries to Residential Consumers per capita (MJ/person)","HDD","CDD","DD"
"1","1990-01",0.02585044552159,1577.38360741919,3975.95844166803,610,0,-610
"2","1990-02",0.0258354959165856,1143.68500280113,2542.3643958097,449,0,-449
"3","1990-03",0.0258295862755072,1098.64878893869,2115.82198765542,369,17,-352
"4","1990-04",0.0258236036331591,1026.35495099617,1739.70200250662,193,46,-147
"5","1990-05",0.0258321275319166,971.444361646746,985.753394175984,50,90,40
"6","1990-06",0.0258492326365299,1338.4692438631,622.939638055553,0,395,395
"7","1990-07",0.0258771429225823,1932.84363383162,525.394192640291,0,471,471
"8","1990-08",0.0259144355453805,1755.23427101129,505.370658031648,0,459,459
"9","1990-09",0.0259621260012246,1922.12076412086,531.777712882799,12,338,326
"10","1990-10",0.0260212860975046,1234.86592637141,671.754541645081,221,47,-174
"11","1990-11",0.0260980271835898,1005.99728076353,1483.34191022537,307,3,-304
"12","1990-12",0.026186715576665,1135.02716540777,2180.7292500731,740,0,-740
"13","1991-01",0.0262886903945759,1561.58357333405,3847.0128205331,881,0,-881
"14","1991-02",0.0263912834985831,1266.59333496121,3141.3777476718,515,0,-515
"15","1991-03",0.0264994847729443,1138.56429094625,2301.76147540328,339,18,-321
"16","1991-04",0.0266074839459757,983.564573448679,1351.53113361261,95,43,-52
"17","1991-05",0.0267137142781497,999.365986222873,757.327611478636,13,251,238
"18","1991-06",0.0268178463110107,1551.09540703772,570.951777933837,0,393,393
"19","1991-07",0.026936034453949,1951.70240751431,499.089576680781,0,497,497
"20","1991-08",0.0270556108629709,1983.99647436605,490.555365410618,0,428,428
"21","1991-09",0.0271785070153217,1748.65011050108,528.52802978531,50,246,196
"22","1991-10",0.0273071792385242,1206.11660447917,687.85877296253,116,55,-61
"23","1991-11",0.0274433200968635,1080.09089470811,1756.66558068181,549,2,-547
"24","1991-12",0.0275881262761187,1232.85032509473,2470.37239853989,619,0,-619
"25","1992-01",0.0277375708907644,1403.17090944957,3220.47264464281,753,0,-753
"26","1992-02",0.0278749616487725,1243.20944455407,3026.62480005311,484,0,-484
"27","1992-03",0.0279971226719801,1094.52554930636,1936.32377107435,380,0,-380
"28","1992-04",0.0281020778133925,1051.27759632306,1720.19197787079,172,51,-121
"29","1992-05",0.0281934705267153,994.997620961463,832.333817959214,65,120,55
"30","1992-06",0.0282702780270944,1217.15463004811,614.85775056413,0,271,271
"31","1992-07",0.028333904056313,1831.95936273559,534.907486292277,0,449,449
"32","1992-08",0.0283809237694101,1850.15101907878,502.93592044285,2,285,283
"33","1992-09",0.0284170944395692,1536.58291580472,489.836755311842,29,197,168
"34","1992-10",0.0284410656197371,1133.34675971988,674.529379863693,137,20,-117
"35","1992-11",0.0284550890218313,1030.44574532182,1396.65321310553,501,1,-500
"36","1992-12",0.0284588748438664,1310.42126313842,2755.28620671012,726,0,-726
"37","1993-01",0.0284497077771447,1558.76298013633,3622.86945661469,816,0,-816
"38","1993-02",0.028457211484014,1361.11931822345,3166.47900837058,683,0,-683
"39","1993-03",0.0284787956626942,1338.9308474302,2992.19058341659,503,2,-501
"40","1993-04",0.0285111066000716,1150.70580354263,2206.00102902214,266,12,-254
"41","1993-05",0.0285564069842562,1036.77054809663,1000.61188591848,35,100,65
"42","1993-06",0.0286134478386867,1245.90910233736,580.171738114769,4,337,333
"43","1993-07",0.028683057887107,1972.33323505423,490.637016240899,0,565,565
"44","1993-08",0.0287640448475798,2294.86568732528,449.436359261133,0,511,511
"45","1993-09",0.0288596934882804,1910.39476818355,486.930014488435,31,194,163
"46","1993-10",0.0289692594202005,1143.92856062326,694.592159753344,231,31,-200
"47","1993-11",0.0290960805859247,1114.69752743084,1773.08818947396,579,4,-575
"48","1993-12",0.0292378830147124,1340.05313943724,2721.79278522359,705,0,-705
"49","1994-01",0.0293934400375453,1692.75262925249,3837.5863732115,897,0,-897
"50","1994-02",0.0295443522018991,1514.1287648823,3505.85287838615,645,0,-645
"51","1994-03",0.0296832852483105,1274.21761719146,2486.18142791444,409,2,-407
"52","1994-04",0.0298071406860043,1082.70301971719,1648.54250799237,136,71,-65
"53","1994-05",0.029925691640694,1063.24602881382,789.363345086967,66,104,38
"54","1994-06",0.0300318055902609,1442.64349916468,521.345606262204,0,426,426
"55","1994-07",0.0301277309884228,2029.81932978537,467.413634698099,0,403,403
"56","1994-08",0.03021363749122,1797.1588383129,419.256148230238,0,348,348
"57","1994-09",0.0302897517100461,1661.02278713088,483.416572446291,31,187,156
"58","1994-10",0.0303578840350064,1230.36441696293,620.725936955182,148,68,-80
"59","1994-11",0.0304199619791051,1045.67937759851,1187.02055464169,334,7,-327
"60","1994-12",0.0304744153699187,1270.5661281203,2239.34159064225,651,0,-651
"61","1995-01",0.0305205067029517,1620.4100109187,3304.3657887114,766,1,-765
"62","1995-02",0.0305729643853417,1435.24332861291,2998.02722142651,585,0,-585
"63","1995-03",0.0306306542065442,1343.31238750292,2470.50012627048,381,15,-366
"64","1995-04",0.0306891044458653,1058.75533929669,1289.28818288834,177,34,-143
"65","1995-05",0.0307544740265691,1054.42509912836,814.965328731233,54,148,94
"66","1995-06",0.0308214522420826,1451.03869403793,537.9950423842,1,280,279
"67","1995-07",0.0308915705962574,1883.84485879527,431.064883939791,0,463,463
"68","1995-08",0.0309664128826244,2327.00288932439,401.676876428979,0,566,566
"69","1995-09",0.0310437397386247,2129.05340292202,449.555041491778,53,199,146
"70","1995-10",0.031126309428839,1220.66698367554,558.110178529823,136,35,-101
"71","1995-11",0.0312189508103936,1109.09832753323,1516.5459164389,525,1,-524
"72","1995-12",0.0313200357976994,1389.15713986228,3026.5126758724,767,0,-767
"73","1996-01",0.0314283003542058,1824.59433837328,3873.31150169423,856,0,-856
"74","1996-02",0.0315344488064468,1669.78344264045,3744.06693888697,614,2,-612
"75","1996-03",0.0316365007021365,1381.14652410728,2639.19137077693,597,0,-597
"76","1996-04",0.0317335875257469,1240.52771687955,2079.37583779736,221,27,-194
"77","1996-05",0.0318294737648514,1140.16185188176,843.4232959478,16,239,223
"78","1996-06",0.0319210534146514,1591.47288168126,515.009483256404,0,348,348
"79","1996-07",0.0320102696179577,2061.69364118173,398.169127091333,0,439,439
"80","1996-08",0.0320945760352344,2097.84025326819,408.537250255546,0,401,401
"81","1996-09",0.0321771831840369,1785.45147471735,446.257685458468,23,180,157
"82","1996-10",0.0322596697028569,1213.25048709944,608.683216574082,147,25,-122
"83","1996-11",0.0323407996945686,1132.56705733421,1608.40720159302,569,0,-569
"84","1996-12",0.0324264990723747,1451.72731318249,2682.0367056718,651,1,-650
"85","1997-01",0.0325122613861171,1762.53797497328,3529.8123602662,840,2,-838
"86","1997-02",0.0325918308083573,1610.55683251563,3302.13385967247,555,0,-555
"87","1997-03",0.0326624241081128,1317.02445145425,2103.98532425866,327,0,-327
"88","1997-04",0.0327223391962046,1106.49445533192,1401.27555601572,274,3,-271
"89","1997-05",0.0327754472491361,1068.07418275018,988.396386780972,54,84,30
"90","1997-06",0.0328188225762634,1312.54552866889,527.030698226489,1,280,279
"91","1997-07",0.0328536353870396,2010.11104924927,436.516420645574,0,508,508
"92","1997-08",0.0328767929362859,2242.74431593677,389.39819041513,0,392,392
"93","1997-09",0.0328937990569891,1906.04995075815,402.187797606062,2,251,249
"94","1997-10",0.0329056240829332,1432.85012374071,570.102412803437,211,84,-127
"95","1997-11",0.0329136435712177,1254.41758796461,1699.58071234268,533,0,-533
"96","1997-12",0.032917934412304,1502.5620222855,2695.37197383826,775,0,-775
"97","1998-01",0.0329142693163205,1692.2209018017,3280.98958425404,651,0,-651
"98","1998-02",0.0329369841281851,1462.53294984288,2821.22608902933,531,0,-531
"99","1998-03",0.0329816030464955,1440.0615877492,2567.25428084592,518,27,-491
"100","1998-04",0.0330417300640174,1203.63477354465,1658.28328055488,176,19,-157
"101","1998-05",0.0331229079417693,1186.78422559966,728.484916283353,12,251,239
"102","1998-06",0.0332243221720568,1862.84069134836,424.822194833322,5,452,447
"103","1998-07",0.0333463830075478,2490.91944096796,406.698761133865,0,597,597
"104","1998-08",0.0334876723581006,2517.72478347931,368.333218137662,0,504,504
"105","1998-09",0.0336521021055229,2246.84894687216,363.827695103486,0,388,388
"106","1998-10",0.0338397607384972,1730.28439761778,468.902220454058,111,69,-42
"107","1998-11",0.0340522352785408,1169.9400753084,1129.02362983476,349,1,-348
"108","1998-12",0.0342912424578279,1332.09752966945,1927.62520672451,679,3,-676
"109","1999-01",0.0345521760905551,1936.56202682586,3836.47203718104,726,0,-726
"110","1999-02",0.0347800647262224,1484.10772673776,2231.89256351014,450,2,-448
"111","1999-03",0.0349662568166378,1404.16023304223,2188.48734029023,509,0,-509
"112","1999-04",0.0351049450361685,1273.00911424728,1582.72800704375,108,49,-59
"113","1999-05",0.035200468349129,1203.85906176648,694.912386395791,18,111,93
"114","1999-06",0.0352519071024753,1614.58241703803,435.505193881652,1,341,340
"115","1999-07",0.0352604291685283,2168.1039245256,420.777079396378,0,516,516
"116","1999-08",0.0352255859393999,2555.46529792651,399.535869573522,0,505,505
"117","1999-09",0.0351498847136828,2221.37852477807,386.978386861411,21,223,202
"118","1999-10",0.0350335615839335,1439.79105549459,526.230557146853,143,44,-99
"119","1999-11",0.0348803355538279,1154.66008602414,503.501904928035,288,0,-288
"120","1999-12",0.0346894646090527,1367.59737062144,2073.08210047147,662,1,-661
"121","2000-01",0.0344569628675803,1647.40167348088,3031.18667470506,744,0,-744
"122","2000-02",0.0342535740817843,1561.54938512209,2330.31823576302,481,3,-478
"123","2000-03",0.0340714997677118,1251.84426716712,1673.45869514226,335,3,-332
"124","2000-04",0.0339049780368474,1150.10005765637,981.589336453735,189,10,-179
"125","2000-05",0.0337631441224656,1212.11525423009,624.655779786762,16,196,180
"126","2000-06",0.0336374638141717,1649.29606922251,366.078889975567,2,302,300
"127","2000-07",0.033526441982789,2182.64589441552,315.279125044072,0,470,470
"128","2000-08",0.033434768058271,2444.20363673809,364.376370019831,0,598,598
"129","2000-09",0.0333590142030313,2392.56805818907,458.406266822869,27,300,273
"130","2000-10",0.0333009191904094,1537.37916677773,590.233593376517,125,86,-39
"131","2000-11",0.0332625037250845,1239.11798311854,2116.30011398243,576,10,-566
"132","2000-12",0.0332407493802006,1702.4041669663,4161.88537990695,1068,0,-1068
"133","2001-01",0.0332394771395153,2160.40603145712,3148.10558971541,896,0,-896
"134","2001-02",0.0332474063601933,1624.10129193954,2617.07447901457,577,0,-577
"135","2001-03",0.0332619406343927,1412.90006399174,2288.37069526195,550,0,-550
"136","2001-04",0.0332825545789972,1277.34284471932,785.907747911433,98,102,4
"137","2001-05",0.0333118465516233,1273.4276771945,375.80550124894,18,166,148
"138","2001-06",0.0333468052376477,1666.32337696654,323.631622153864,1,319,318
"139","2001-07",0.03339030293878,2210.92924327727,385.924696873041,0,531,531
"140","2001-08",0.033440644805333,2505.12119792303,321.63513875133,0,502,502
"141","2001-09",0.0334979938234876,2131.57239616162,307.969027445367,32,205,173
"142","2001-10",0.0335724291808565,1402.28310992449,611.809734486689,198,24,-174
"143","2001-11",0.03365140934048,1121.71965150773,1358.13348875348,316,4,-312
"144","2001-12",0.033740622093001,1419.69635074654,2294.29401418087,643,0,-643
"145","2002-01",0.03384031860766,1856.69003753846,2871.48065192446,734,3,-731
"146","2002-02",0.0339383495599088,1589.70785126394,2768.03819445002,665,0,-665
"147","2002-03",0.0340373392291521,1527.98511211165,2453.88567453054,553,0,-553
"148","2002-04",0.034131813516451,1326.33149302228,1472.47375932059,133,78,-55
"149","2002-05",0.0342228586569034,1353.8065181428,599.542224128914,64,111,47
"150","2002-06",0.0343100599339179,1622.66581357829,422.943583882386,0,342,342
"151","2002-07",0.0343969411457453,2158.47502298203,331.070450105625,0,484,484
"152","2002-08",0.0344807158624016,2361.54872810462,310.23826256921,0,464,464
"153","2002-09",0.0345613663091404,2340.91803169284,315.164321679245,4,305,301
"154","2002-10",0.0346417571007691,1687.52366696072,482.330485079047,204,55,-149
"155","2002-11",0.0347228171502854,1274.92025938026,1234.21216719443,526,3,-523
"156","2002-12",0.0348069316943738,1564.93847525704,2273.32716054239,723,0,-723
"157","2003-01",0.03488970596923,1915.1753112188,3059.98065863485,899,0,-899
"158","2003-02",0.0349845336530838,1843.31092888212,3186.16960601359,726,0,-726
"159","2003-03",0.0350853052543385,1636.89212346905,2515.63236833197,449,0,-449
"160","2003-04",0.0351892478177274,1254.94129865224,1201.58730267191,141,42,-99
"161","2003-05",0.0352966457441618,1349.33602764717,584.201212147061,15,157,142
"162","2003-06",0.0353959160062801,1618.04871363159,364.064188579476,3,243,240
"163","2003-07",0.0354973101641806,2156.79457935268,327.497517456878,0,464,464
"164","2003-08",0.0356042227944276,2396.51772178185,303.591266559013,0,492,492
"165","2003-09",0.0357183216030232,2189.94588131858,315.933743814706,21,173,152
"166","2003-10",0.035837998708624,1393.18648511822,405.698987548592,115,42,-73
"167","2003-11",0.035964500789883,1232.87481275516,811.150559026683,347,21,-326
"168","2003-12",0.0361007447551647,1640.82193249157,1911.29149623839,726,0,-726
"169","2004-01",0.0362437702937277,1919.14594843599,2743.66567343777,777,1,-776
"170","2004-02",0.0363831822693035,1828.11815966461,2916.18071657766,743,0,-743
"171","2004-03",0.0365149845527544,1529.1182321259,2036.73006518564,315,10,-305
"172","2004-04",0.0366341049942484,1245.67914256454,1083.74810715276,174,35,-139
"173","2004-05",0.0367439096651823,1310.39716540043,565.668616877887,34,211,177
"174","2004-06",0.0368494927948922,1800.12140816347,337.33602510106,0,321,321
"175","2004-07",0.0369469045332205,2159.54649521466,313.230620024074,0,398,398
"176","2004-08",0.0370353372799643,2199.78353408951,303.583130233214,2,325,323
"177","2004-09",0.0371171726137076,2005.22180600091,319.682045365356,1,234,233
"178","2004-10",0.0371907523619783,1600.47683541732,383.641504663845,74,85,11
"179","2004-11",0.0372621563948622,1314.42527585427,725.386743907818,348,5,-343
"180","2004-12",0.0373286795839174,1564.24339668782,1868.39587307538,741,0,-741
"181","2005-01",0.0373883577717097,1982.65215996776,2657.9160724575,665,1,-664
"182","2005-02",0.0374554833665027,1752.49188251551,2332.40902933158,525,0,-525
"183","2005-03",0.0375183126806509,1527.33263847617,1840.2148500111,495,0,-495
"184","2005-04",0.0375744798472294,1337.27391305467,1238.42716027291,166,19,-147
"185","2005-05",0.0376272243194771,1317.19846617659,593.580499025076,77,138,61
"186","2005-06",0.0376809811127247,1879.85354958326,335.737661795561,0,371,371
"187","2005-07",0.0377310866853954,2431.77230851054,293.621683685654,0,470,470
"188","2005-08",0.0377800941060928,2559.24437273617,268.184967724818,0,536,536
"189","2005-09",0.0378264529775296,2464.88512871184,284.409619504341,6,361,355
"190","2005-10",0.0378719797356044,1864.27486682527,357.926087510791,187,78,-109
"191","2005-11",0.0379237471511973,1348.85511216199,832.254345632437,364,10,-354
"192","2005-12",0.0379693310087574,1748.66084671406,1969.74907884948,812,0,-812
"193","2006-01",0.0380164512142394,1959.06301638503,2166.48845814234,547,0,-547
"194","2006-02",0.0380510607503953,1695.16085478148,2093.25811369354,687,0,-687
"195","2006-03",0.038077372338056,1641.93770928009,1876.72323874419,385,16,-369
"196","2006-04",0.0380890848513468,1401.36015586058,1005.1035038932,74,107,33
"197","2006-05",0.0380898749865391,1414.76256783973,412.532411959898,36,187,151
"198","2006-06",0.0380752760094821,1914.40204226743,335.080320464814,0,339,339
"199","2006-07",0.0380472785981777,2351.54200930483,275.698042425104,0,517,517
"200","2006-08",0.0380088789453204,2662.68746970497,244.234130876478,0,546,546
"201","2006-09",0.0379553588623032,2170.33029165575,285.413353432154,18,170,152
"202","2006-10",0.0378933097807506,1503.09729080806,426.421365560588,216,54,-162
"203","2006-11",0.0378214563076358,1390.79861551857,1079.09755887655,400,4,-396
"204","2006-12",0.0377345929406439,1716.7783376686,1817.93651898188,618,0,-618
"205","2007-01",0.0376397087213563,1966.60030268737,2331.32729761399,795,0,-795
"206","2007-02",0.0375578081511838,2090.48322063874,2888.95735780418,683,0,-683
"207","2007-03",0.0374870642996151,1648.10391685607,1599.0704628938,210,37,-173
"208","2007-04",0.0374223066364745,1303.72378015147,905.866529211693,262,22,-240
"209","2007-05",0.0373680047103125,1396.13025580159,552.241547738023,13,191,178
"210","2007-06",0.0373205384933275,1801.89614102894,332.007869434665,0,363,363
"211","2007-07",0.0372799692189894,2200.67898264489,277.011311226273,0,406,406
"212","2007-08",0.0372483045259414,2506.78511876296,253.394702945628,0,594,594
"213","2007-09",0.0372259476215485,2360.77443744652,265.226906995615,1,283,282
"214","2007-10",0.0372153279868349,1702.84948569409,300.388270379908,135,107,-28
"215","2007-11",0.0372134677155551,1371.62366757254,870.663400093638,389,8,-381
"216","2007-12",0.0372228969020413,1708.07272535627,1790.96224698094,654,1,-653
"217","2008-01",0.0372448567174568,2119.88375022604,2587.10086852686,817,1,-816
"218","2008-02",0.0372480394897567,2026.51710349171,2611.12537613101,649,2,-647
"219","2008-03",0.037230573436827,1758.33801337092,1922.35499485755,406,6,-400
"220","2008-04",0.0371959396368271,1370.33670452072,1075.06065480446,213,23,-190
"221","2008-05",0.0371370118573589,1339.47982298889,592.754122960124,35,152,117
"222","2008-06",0.0370589780711428,1882.20927848255,333.786649055479,0,386,386
"223","2008-07",0.0369592883073567,2266.38862836481,261.011010868255,0,487,487
"224","2008-08",0.0368380301677508,2421.55468963613,254.845150635526,0,394,394
"225","2008-09",0.0366980757911129,1924.60355688811,280.442081317806,7,186,179
"226","2008-10",0.0365400445554036,1455.4707593308,354.542153711244,184,32,-152
"227","2008-11",0.0363636140386828,1343.8321728304,920.9419819366,490,0,-490
"228","2008-12",0.0361712443653465,1925.99809199819,2180.42348121687,744,1,-743
"229","2009-01",0.0359575991897974,2163.27688689175,2704.23605135646,833,0,-833
"230","2009-02",0.035776236967363,1903.49887488202,2303.393793244,512,0,-512
"231","2009-03",0.0356229575954867,1633.42853539012,1641.30513151587,388,16,-372
"232","2009-04",0.0355005011657802,1351.26405822232,1146.96430558768,216,49,-167
"233","2009-05",0.0354053973082084,1331.60004413273,477.901733368819,44,121,77
"234","2009-06",0.0353384335081398,1739.25469298394,330.008672803743,0,412,412
"235","2009-07",0.035299430797353,2405.16644050063,254.724394844385,0,397,397
"236","2009-08",0.035288991502509,2242.23962763195,256.715402750899,1,370,369
"237","2009-09",0.0353047467633136,1863.31778759535,259.406319159996,8,197,189
"238","2009-10",0.0353505995415805,1445.37551059247,399.787748614232,257,5,-252
"239","2009-11",0.0354264631188881,1290.92627690561,773.16067633872,341,0,-341
"240","2009-12",0.0355356824844527,1795.23469157267,1810.25378893772,846,0,-846
"241","2010-01",0.035671257446858,2547.84947589987,3051.75092747983,894,0,-894
"242","2010-02",0.0358006518603017,2173.25744237677,2700.17373069496,804,0,-804
"243","2010-03",0.0359244872322553,1879.95526886299,2306.9208473366,448,0,-448
"244","2010-04",0.0360407860839652,1344.16746059651,1011.15790953493,90,37,-53
"245","2010-05",0.0361499709868488,1338.13785171063,379.643684428713,21,210,189
"246","2010-06",0.0362524635253416,2041.72536035335,284.605535877026,0,495,495
"247","2010-07",0.0363455153548644,2575.53478106917,234.114807103487,0,537,537
"248","2010-08",0.0364294822856566,2740.75572018832,229.170937555077,0,594,594
"249","2010-09",0.0365046760112046,2298.71218920334,235.963533381489,6,297,291
"250","2010-10",0.0365728087874082,1586.03286646521,334.66703287193,110,38,-72
"251","2010-11",0.036638471153181,1299.22935066282,699.020753048242,394,3,-391
"252","2010-12",0.0366982093512769,1873.00791122779,1861.0120400896,790,0,-790
"253","2011-01",0.0367489972480396,2376.2351329383,2860.49168175747,868,0,-868
"254","2011-02",0.036796037428962,2177.0421268497,2523.01690791763,600,0,-600
"255","2011-03",0.0368370997091273,1576.21485154045,1458.44330625363,408,11,-397
"256","2011-04",0.0368659716841439,1404.54485379596,1053.09877127771,114,66,-48
"257","2011-05",0.0368874218983519,1391.5302365307,481.81966632482,83,163,80
"258","2011-06",0.0369019387326948,2057.244301507,296.897570263661,0,509,509
"259","2011-07",0.0369044316441627,2664.46928497734,272.687260374453,0,626,626
"260","2011-08",0.036899056352074,2763.41313708167,208.357479977752,0,569,569
"261","2011-09",0.0368831990045885,2159.43361599416,250.569479773187,18,166,148
"262","2011-10",0.036862448198463,1406.27495772569,343.808774955606,168,37,-131
"263","2011-11",0.0368366327637362,1313.15861533161,819.713085196085,362,10,-352
"264","2011-12",0.0368031970940535,1727.34015975018,1753.34882237364,665,0,-665
"265","2012-01",0.0367615666043986,2028.64301722364,2034.01754898179,640,0,-640
"266","2012-02",0.0367396436730971,1785.42345192356,1696.46619966312,528,1,-527
"267","2012-03",0.0367276786406093,1534.50110266619,1096.34618793077,141,62,-79
"268","2012-04",0.0367305026905559,1281.29782105745,417.545294619481,99,74,-25
"269","2012-05",0.0367480202061743,1463.34442783801,292.624317479344,4,265,261
"270","2012-06",0.0367766458634004,1991.07519880968,236.510607001956,1,411,410
"271","2012-07",0.0368181504032089,2529.79351664331,220.436037244878,0,617,617
"272","2012-08",0.0368711227832216,2632.48399754934,200.358437200337,0,480,480
"273","2012-09",0.0369362117046311,2138.16054640042,224.632118016961,5,261,256
"274","2012-10",0.0370174407014278,1487.15573016313,416.049473313664,207,39,-168
"275","2012-11",0.0371148357039459,1356.86000285203,1064.36912950366,437,0,-437
"276","2012-12",0.0372285839819918,1632.7009085387,1629.29681659629,586,4,-582
"277","2013-01",0.0373581045947215,2165.07128006058,2404.02734878533,713,1,-712
"278","2013-02",0.0374810009720893,1870.62715376146,1930.44516095911,623,0,-623
"279","2013-03",0.0375908208812133,1845.34424686588,1807.20236023575,558,0,-558
"280","2013-04",0.0376871734703829,1544.22510758259,883.322203306667,230,45,-185
"281","2013-05",0.0377747273368246,1352.74021877331,499.889439560243,75,148,73
"282","2013-06",0.0378448427332377,1758.62699913838,266.031295000438,0,368,368
"283","2013-07",0.037905514930452,2259.96197476066,222.068309027605,0,411,411
"284","2013-08",0.0379527877460841,2248.99587929152,222.369024471744,0,426,426
"285","2013-09",0.0379866241693071,2153.98756414399,219.754062351255,2,309,307
"286","2013-10",0.0380106934936136,1637.45856427152,384.993118601861,168,67,-101
"287","2013-11",0.0380245550069131,1358.26263284478,1353.60432177726,528,5,-523
"288","2013-12",0.0380325930909866,1987.57184476009,2501.68743607882,780,0,-780
"289","2014-01",0.0380291301315558,2433.76196683829,3330.89877757206,915,0,-915
"290","2014-02",0.0380283183331672,2347.82585770349,2726.63244683243,744,1,-743
"291","2014-03",0.0380288187701769,1912.71135328335,1891.45967176615,556,0,-556
"292","2014-04",0.0380281182126935,1388.35931013725,891.988503031247,189,18,-171
"293","2014-05",0.0380254664690609,1290.26121102789,458.026410824046,70,177,107
"294","2014-06",0.038022322234498,1714.42707943931,292.485062866932,0,358,358
"295","2014-07",0.0380189463529218,2119.9541715523,234.503775108415,0,330,330
"296","2014-08",0.0380108025586943,2154.95236465036,247.429672018724,0,434,434
"297","2014-09",0.0380034826348452,2174.09083247883,259.98460506521,9,242,233
"298","2014-10",0.0379970386809009,1544.40899470907,332.892691278981,106,64,-42
"299","2014-11",0.0379928093648879,1420.09346259824,974.833849078537,591,0,-591
"300","2014-12",0.0379921948834164,1892.36368145542,2159.34854520483,668,0,-668
"301","2015-01",0.0379930132739074,2295.49379247233,2917.86775259684,805,0,-805
"302","2015-02",0.0379991690997691,2063.94068337105,2786.75727924335,816,0,-816
"303","2015-03",0.0380035702493716,2170.46450687674,1749.4017853457,452,1,-451
"304","2015-04",0.0380063106780194,1299.40001982894,589.715769263226,124,43,-81
"305","2015-05",0.0380084931968986,1287.89810886894,339.86894744448,25,151,126
"306","2015-06",0.0380104542454015,1743.21096661709,240.572248794283,0,403,403
"307","2015-07",0.0380106435907721,2372.44700538954,215.601362626455,0,536,536
"308","2015-08",0.0380092407024793,2508.73821491455,200.728809924438,0,411,411
"309","2015-09",0.0380082272118078,2012.51454372623,211.082657563376,2,298,296
"310","2015-10",0.0380067981757959,1536.20451088666,286.226294051917,96,50,-46
"311","2015-11",0.0380105406655321,1242.14601048805,849.721754891178,331,1,-330
"312","2015-12",0.0380129744848964,1577.34373875553,1534.6763750079,480,5,-475
"313","2016-01",0.0380223580942691,2026.41974516811,2172.29753834412,785,0,-785
"314","2016-02",0.0380313784563812,1913.422210753,1777.68426844229,534,0,-534
"315","2016-03",0.0380380191480056,1526.63017707578,992.837065597677,299,8,-291
"316","2016-04",0.038042700035849,1253.11428110541,542.623418968196,109,30,-79
"317","2016-05",0.0380454829229122,1252.68350135601,336.603239390879,49,116,67
"318","2016-06",0.0380469826262114,1732.22014114974,246.711501550105,0,432,432
"319","2016-07",0.0380451046628176,2493.96647553177,209.639150466762,0,543,543
"320","2016-08",0.0380420684427982,2418.68401576204,195.560516846898,0,476,476
"321","2016-09",0.0380379327916677,2101.81563196996,218.436897632615,0,364,364
"322","2016-10",0.0380319000388395,1694.39481340748,263.159213737722,27,149,122
"323","2016-11",0.0380289689058171,1312.45829865534,655.894928824204,304,19,-285
"324","2016-12",0.0380273335445488,1699.15180699948,2130.92424903513,697,1,-696
"325","2017-01",0.0380237346073731,2090.90976196818,2056.16447043034,615,2,-613
"326","2017-02",0.0380221550857767,1585.01753703644,1209.07787869359,352,3,-349
"327","2017-03",0.0380157487332073,1463.60223723007,1056.52241371356,305,12,-293
"328","2017-04",0.0380052604860564,1287.74612121706,417.994229352578,86,53,-33
"329","2017-05",0.0379892626558859,1324.8059001084,340.507151087071,37,133,96
"330","2017-06",0.0379690213764806,1751.94122269462,221.973454953094,0,328,328
"331","2017-07",0.0379429927868085,2157.37366411046,203.584639367715,0,494,494
"332","2017-08",0.0379121485991875,2275.93861952981,197.336554959362,0,372,372
"333","2017-09",0.0378777753019033,1897.89875673522,208.90962532251,3,259,256
"334","2017-10",0.0378399247787989,1653.70225843363,331.555003063962,165,105,-60
"335","2017-11",0.0378011636064532,1359.05857554154,904.320831929475,339,24,-315
"336","2017-12",0.0377607448109231,1663.86803381814,2030.20403600087,708,0,-708
