"","Date","Real GDP per capita (millions of chained 2012 dollars per person)","Electricity Sale to Residential Consumers per capita (MJ/person)","Natural Gas Deliveries to Residential Consumers per capita (MJ/person)","HDD","CDD","DD"
"1","1990-01",0.0201382055117163,3791.32702007312,1563.49615223333,1076,0,-1076
"2","1990-02",0.020105421943837,3079.95545767056,1532.72838469512,1017,0,-1017
"3","1990-03",0.0200717780685867,3041.01662717689,1162.24330680437,744,0,-744
"4","1990-04",0.0200207089573588,2749.3958183112,677.324405729896,399,0,-399
"5","1990-05",0.0199790194162612,2446.08064388758,509.436726541928,369,0,-369
"6","1990-06",0.019935922233322,2700.07567354936,385.095610423126,144,76,-68
"7","1990-07",0.0198954884168993,3689.75675020342,184.586219308858,12,224,212
"8","1990-08",0.0198551485350773,3493.73456225287,170.263731128244,26,181,155
"9","1990-09",0.019816714751729,3488.70359397798,197.40846921842,51,79,28
"10","1990-10",0.0197820369074921,2728.36155771784,369.463507364564,551,0,-551
"11","1990-11",0.0197617797937311,2805.79983755039,946.727486393038,830,0,-830
"12","1990-12",0.0197457409802499,3389.33475724724,1473.46065147169,1487,0,-1487
"13","1991-01",0.0197360706773472,4034.46403402892,2258.89764582276,1330,0,-1330
"14","1991-02",0.0197295785373191,3150.71332309391,1544.16653040212,782,0,-782
"15","1991-03",0.0197348356746762,2958.45899759033,1111.31442255669,810,0,-810
"16","1991-04",0.0197417173166946,2596.1608170482,951.957018574887,589,0,-589
"17","1991-05",0.0197475534057536,2731.89992164177,727.045518496499,393,0,-393
"18","1991-06",0.0197518331477533,3396.35876025592,409.280135584044,151,12,-139
"19","1991-07",0.0197818616432546,4027.53826981375,201.597064005322,9,200,191
"20","1991-08",0.0198160219007664,3344.89272906459,185.564317458544,4,223,219
"21","1991-09",0.0198575174891121,3165.27901395519,224.407130177373,140,34,-106
"22","1991-10",0.0199103794206955,2791.30643329101,323.97239789277,528,0,-528
"23","1991-11",0.0199773223979782,3055.57449665116,1120.30025447277,933,0,-933
"24","1991-12",0.0200602267640141,3418.475445502,1602.67374125292,1134,0,-1134
"25","1992-01",0.0201523282854264,3530.17743031848,1891.63433604847,1136,0,-1136
"26","1992-02",0.0202476417891855,3041.76314275699,1394.72934807576,791,0,-791
"27","1992-03",0.020340817574498,2879.13415960223,965.64363588516,613,0,-613
"28","1992-04",0.0204285021105932,2663.45649058717,745.082661383393,418,2,-416
"29","1992-05",0.0205166208859352,2388.69732900419,453.137575897614,168,27,-141
"30","1992-06",0.0206033770449842,2558.57907886343,250.882532160922,82,114,32
"31","1992-07",0.0206909784504032,2910.1135134675,236.04543585819,34,112,78
"32","1992-08",0.0207736486968974,2816.94224087779,184.841717904478,62,211,149
"33","1992-09",0.0208607859666515,2431.58703160641,275.962318667531,211,17,-194
"34","1992-10",0.0209500473670793,2668.27181771414,429.819215594634,443,7,-436
"35","1992-11",0.0210450669401267,3241.43218105049,1025.54085227421,987,0,-987
"36","1992-12",0.0211452875812995,3601.40113192637,1943.85120945001,1299,0,-1299
"37","1993-01",0.0212461019210334,3665.3699713325,2256.40612227752,1384,0,-1384
"38","1993-02",0.0213492250098026,2965.20735690462,1946.78066646578,1150,0,-1150
"39","1993-03",0.0214504204602305,3177.46993560949,1690.27551631945,861,0,-861
"40","1993-04",0.0215441119885938,2474.85569908971,1032.25775497791,591,0,-591
"41","1993-05",0.021634165907431,2437.20231251945,682.387043602607,205,30,-175
"42","1993-06",0.0217185437622906,2597.78003466565,328.43521200718,203,28,-175
"43","1993-07",0.0217987125406386,3529.69931850075,296.114580553303,124,24,-100
"44","1993-08",0.0218727368135534,3839.68644311002,245.362777864148,76,72,-4
"45","1993-09",0.0219462189840318,2638.03243288966,302.149851547399,212,19,-193
"46","1993-10",0.0220179605831182,2420.75029283644,467.466641898356,494,0,-494
"47","1993-11",0.022093588262237,2721.98427937533,1123.47389294015,1063,0,-1063
"48","1993-12",0.0221692970058013,3828.91019221529,1989.02739281931,1128,0,-1128
"49","1994-01",0.0222430511315801,3920.17133184537,1860.70669740602,1052,0,-1052
"50","1994-02",0.0223296793575455,2887.78795968358,1853.98371515059,1015,0,-1015
"51","1994-03",0.0224169289634939,2922.40699730524,1375.37981015158,719,0,-719
"52","1994-04",0.0224996469815209,2276.27943235721,958.896557805607,475,3,-472
"53","1994-05",0.022593893454467,2310.01269082212,542.854606309628,229,14,-215
"54","1994-06",0.0226878337136032,3370.35647642699,349.873142752011,125,80,-45
"55","1994-07",0.0227851004805264,3390.80724616617,283.369422084051,17,240,223
"56","1994-08",0.0228858966444985,3284.00312355612,201.072330095947,9,212,203
"57","1994-09",0.0229905178463807,2675.83657863089,258.257402960245,99,22,-77
"58","1994-10",0.0231018694923028,2421.82237500517,551.094365324364,558,0,-558
"59","1994-11",0.0232230715249775,2526.42678498946,1370.89772679535,1071,0,-1071
"60","1994-12",0.023351498210963,3098.38103645557,2104.64994663946,1189,0,-1189
"61","1995-01",0.0234858946165961,3451.81229009307,2226.98670554392,1108,0,-1108
"62","1995-02",0.0236150459697539,2693.66391325852,1647.24365757056,799,0,-799
"63","1995-03",0.0237371743978015,2829.52542166154,1404.20266663205,804,0,-804
"64","1995-04",0.0238448955255755,2444.6775164761,1187.85794281231,587,0,-587
"65","1995-05",0.0239485754414171,2395.06283923218,851.584038114157,350,3,-347
"66","1995-06",0.0240394125649088,2883.25295148791,500.648190487128,172,28,-144
"67","1995-07",0.024120045506003,3943.04255663879,313.308090369139,26,135,109
"68","1995-08",0.0241932074485078,4696.8778217983,234.974967112829,55,104,49
"69","1995-09",0.0242552282320842,2782.30161780039,280.639996295271,159,44,-115
"70","1995-10",0.0243108027537373,2119.79859284901,578.578282776769,600,0,-600
"71","1995-11",0.0243680537002117,2636.3057129239,1254.65805233555,748,0,-748
"72","1995-12",0.0244242863202525,3091.67991324149,1605.80600519121,1076,0,-1076
"73","1996-01",0.0244774117614127,3466.59691525923,2173.95689604664,1162,0,-1162
"74","1996-02",0.0245147760089816,2953.44867064989,2300.81363991801,1041,0,-1041
"75","1996-03",0.0245331214588943,2821.69432346499,1690.92997367636,795,0,-795
"76","1996-04",0.0245310696624623,2358.51646194994,1202.09665415273,548,0,-548
"77","1996-05",0.0245148802188716,2373.93769536053,890.906174382023,401,0,-401
"78","1996-06",0.0244794866155031,3100.2567678251,493.938137258273,103,43,-60
"79","1996-07",0.0244281260269168,3174.89918351933,272.938112731376,11,211,200
"80","1996-08",0.0243567270626228,3376.40370820136,251.534079966869,33,147,114
"81","1996-09",0.0242705504635768,2773.94894027841,329.904976337954,270,19,-251
"82","1996-10",0.0241721189112906,2457.57908396228,584.427273417755,547,0,-547
"83","1996-11",0.0240594354280777,2843.44037367701,1417.78751562231,833,0,-833
"84","1996-12",0.02394174260102,3269.15345056761,2005.5300729543,1110,0,-1110
"85","1997-01",0.023811798602203,3550.85133547739,2307.25237468088,1156,0,-1156
"86","1997-02",0.0237672690682385,2766.00757697473,2284.59774272281,941,0,-941
"87","1997-03",0.0238034614238598,2630.08988334207,1712.95321955976,786,0,-786
"88","1997-04",0.0239173622251272,2476.82280789179,1312.10371198272,624,0,-624
"89","1997-05",0.0241144852469767,2271.72880548908,839.988677809197,248,20,-228
"90","1997-06",0.0243898354405464,2906.46861406704,387.115202883408,96,32,-64
"91","1997-07",0.0247446928702327,3884.3537404168,307.907260065028,40,135,95
"92","1997-08",0.0251735268887437,3165.83948641531,261.864577922539,10,163,153
"93","1997-09",0.0256844725905107,2763.68525545776,284.472277289153,138,52,-86
"94","1997-10",0.0262787230090337,2554.73886896985,566.146430125635,556,3,-553
"95","1997-11",0.0269583634398468,2703.03619997338,1264.28385354953,831,0,-831
"96","1997-12",0.0277235183562253,3040.24736733254,2097.780814378,1202,0,-1202
"97","1998-01",0.0285666299736734,3180.95175943131,2632.87737235397,1033,0,-1033
"98","1998-02",0.029346915596006,2377.76126965925,1973.51769697352,863,0,-863
"99","1998-03",0.0300569402971408,2761.51182005068,1794.45980014105,807,0,-807
"100","1998-04",0.0306846305910503,2267.88688973962,1376.56526944986,563,0,-563
"101","1998-05",0.0312405263309096,2441.28696745817,796.991576045471,337,1,-336
"102","1998-06",0.0317231201214174,2927.50194895106,586.04790107789,180,7,-173
"103","1998-07",0.0321332008819334,3821.80843927924,353.667830646939,0,273,273
"104","1998-08",0.0324678176781079,3673.89666542925,255.926416387725,7,211,204
"105","1998-09",0.0327346637249023,3094.76667779185,276.642750129015,101,103,2
"106","1998-10",0.0329336635872225,2476.40548504987,574.579396932262,546,0,-546
"107","1998-11",0.0330675879105363,2550.29465514789,1319.46889975465,785,0,-785
"108","1998-12",0.033139233857646,3094.25627004716,2129.1771356931,1208,0,-1208
"109","1999-01",0.0331386010270445,3283.88643803642,2703.08778815032,1069,0,-1069
"110","1999-02",0.0331874282626805,2572.94210126708,2303.16137085875,947,0,-947
"111","1999-03",0.0332691606442134,2628.51650964308,1972.65717106259,821,0,-821
"112","1999-04",0.0333728811288857,2253.17668098729,1635.48324913879,631,0,-631
"113","1999-05",0.0335072007997433,2253.52892716041,1083.32960598426,404,13,-391
"114","1999-06",0.0336701361090964,2936.34331601568,560.758229536207,161,57,-104
"115","1999-07",0.0338635050405288,4627.70940655081,370.798889221581,40,145,105
"116","1999-08",0.034085690967307,3412.06523596752,310.179268858181,15,190,175
"117","1999-09",0.0343406993956257,2746.76110193205,376.090406097095,212,13,-199
"118","1999-10",0.0346278768417115,2181.83868292411,743.403478484149,489,0,-489
"119","1999-11",0.0349535402821452,2341.96474160886,1303.91443384104,693,0,-693
"120","1999-12",0.035314915604554,2896.30904004688,2134.09971993868,1142,0,-1142
"121","2000-01",0.0357019692949046,3279.55934442038,2815.40321157754,1126,0,-1126
"122","2000-02",0.0360386121695639,2572.28302418197,2287.14020763848,857,0,-857
"123","2000-03",0.0363123944533323,2414.66893997018,1928.52151276638,799,0,-799
"124","2000-04",0.0365139606856323,2255.60177488188,1417.57974665429,446,0,-446
"125","2000-05",0.0366667205473661,2284.28151655195,758.063845494572,284,6,-278
"126","2000-06",0.0367541456121047,2655.47982369371,526.459461575903,98,62,-36
"127","2000-07",0.0367748504584525,3487.07690789205,363.317606172603,14,215,201
"128","2000-08",0.036741224463352,3697.29229492144,288.842168109884,16,202,186
"129","2000-09",0.0366467401752746,2806.82487528427,399.753915120897,222,32,-190
"130","2000-10",0.0364962571849155,2249.80684005839,708.264733619866,530,0,-530
"131","2000-11",0.0362948060393786,2302.10057175943,1768.03257336463,1071,0,-1071
"132","2000-12",0.0360355150657535,3311.5597863964,2691.81634323054,1213,0,-1213
"133","2001-01",0.0357265203298812,3278.88234563694,2877.18105398599,1290,0,-1290
"134","2001-02",0.035457103523726,2739.55277447917,2847.09712109649,1039,0,-1039
"135","2001-03",0.0352210048340734,2592.93201257482,1959.05967894609,762,0,-762
"136","2001-04",0.0350167114193437,2251.28294945645,1476.52171365121,599,0,-599
"137","2001-05",0.0348495082602897,2213.06143947572,874.168809359348,257,29,-228
"138","2001-06",0.034712575527149,2719.2803409681,479.202483471865,132,71,-61
"139","2001-07",0.0346118014266477,3839.41391930708,337.915596652245,13,200,187
"140","2001-08",0.0345433097844758,3933.88839876263,278.631457144422,5,243,238
"141","2001-09",0.0345072418382672,2461.8879353758,345.927471085994,97,48,-49
"142","2001-10",0.0345246054406832,2224.91128389441,581.091192481073,515,0,-515
"143","2001-11",0.0345687962577234,2737.07571428869,1302.98957838249,760,0,-760
"144","2001-12",0.0346516710143221,2876.62864380949,2297.63322573635,1248,0,-1248
"145","2002-01",0.034773676903944,3088.40683745421,2804.31066097097,1203,0,-1203
"146","2002-02",0.0348849168675575,2602.14365317691,2794.92249512689,1096,0,-1096
"147","2002-03",0.0349909152208505,2656.47612985271,2268.63370219961,949,0,-949
"148","2002-04",0.0350802212043527,2351.36597408835,1453.80494792943,540,0,-540
"149","2002-05",0.035155137129772,2212.58759301159,1000.37519802741,345,19,-326
"150","2002-06",0.0352148244246024,3006.76308076703,562.686525516807,247,29,-218
"151","2002-07",0.0352666559667048,4167.34607914783,315.537837904696,6,294,288
"152","2002-08",0.0353048266549946,3658.66639097587,289.324246645967,28,93,65
"153","2002-09",0.0353293186276688,2965.77397021769,354.636562703392,168,39,-129
"154","2002-10",0.0353460722143481,2363.77543220775,695.33527680703,621,0,-621
"155","2002-11",0.0353569650811078,2570.84781921436,1721.42021558288,890,0,-890
"156","2002-12",0.0353668345178781,3008.44103069969,2192.37289062367,1015,0,-1015
"157","2003-01",0.0353665547042673,3186.67231860358,2412.443438518,978,0,-978
"158","2003-02",0.0353898627905216,2896.40654898994,2199.22404613535,917,0,-917
"159","2003-03",0.0354241267725334,2673.02525312176,1972.05627002923,724,0,-724
"160","2003-04",0.0354636381086377,2296.70540255739,1478.31809853312,561,0,-561
"161","2003-05",0.0355089498407785,2089.6667445923,1115.77296931019,340,42,-298
"162","2003-06",0.035536607907602,2540.00804518211,501.720353281457,83,82,-1
"163","2003-07",0.0355674647184305,3704.65089502365,327.221315730577,3,333,330
"164","2003-08",0.0356083482905891,3852.57688412391,279.927975896069,5,242,237
"165","2003-09",0.0356625495662007,2688.63567410552,356.761807108399,166,49,-117
"166","2003-10",0.0357267823358944,2341.23587248839,512.889327696706,384,5,-379
"167","2003-11",0.0358034941266727,2503.8803912747,1514.73928630451,981,0,-981
"168","2003-12",0.0358984418065685,2920.38099193318,2351.14031641866,1037,0,-1037
"169","2004-01",0.0360056707254082,3405.43111464927,3144.49097446047,1259,0,-1259
"170","2004-02",0.036129840040461,2983.89087478426,2745.7237336216,1022,0,-1022
"171","2004-03",0.0362629283782547,2474.96418750578,1942.67019823795,682,0,-682
"172","2004-04",0.0363948054894561,2192.08093874762,1146.87368076582,457,0,-457
"173","2004-05",0.0365320678047946,2244.45062940305,794.033607877356,315,3,-312
"174","2004-06",0.0366847138553491,2631.18738349616,554.587130775959,97,75,-22
"175","2004-07",0.0368448129846964,3324.11440089783,357.888814060359,9,234,225
"176","2004-08",0.0370106521461303,2881.20656080721,306.01587123575,41,182,141
"177","2004-09",0.0371868423139374,2722.50745206969,413.607703591043,198,19,-179
"178","2004-10",0.0373699694361488,2372.47712854964,627.137886292786,483,0,-483
"179","2004-11",0.0375720346633194,2466.21004667677,1581.25035439729,907,0,-907
"180","2004-12",0.0377875768011431,2963.20797670612,2477.90281961398,1072,0,-1072
"181","2005-01",0.0380125762880435,3381.51128259743,2907.75817045314,1190,0,-1190
"182","2005-02",0.0382368663347206,2578.73254752197,2509.66286213855,996,0,-996
"183","2005-03",0.0384369751231059,2584.94181383853,1807.44871806246,787,0,-787
"184","2005-04",0.0386081775477677,2251.20653677522,1615.28211450933,568,0,-568
"185","2005-05",0.0387571121455176,2178.07135588365,878.87339087902,320,3,-317
"186","2005-06",0.0388929089417965,2843.53102822736,570.978687526707,198,27,-171
"187","2005-07",0.0390062826645522,4174.27579673815,381.029581916859,6,201,195
"188","2005-08",0.0391025874408565,3607.18175016323,286.423294900393,25,158,133
"189","2005-09",0.0391788737818913,2821.68074363897,404.83470979124,235,15,-220
"190","2005-10",0.0392390356894318,2388.08915869196,694.124658453263,509,0,-509
"191","2005-11",0.0392976088161142,2341.97525681756,1440.12587080012,922,0,-922
"192","2005-12",0.0393296509035513,3109.28057663768,2905.62187915569,1293,0,-1293
"193","2006-01",0.0393510235946927,3125.20644972264,2765.38932734709,1041,0,-1041
"194","2006-02",0.0393654151395372,2581.34456712105,2615.32776074954,1032,0,-1032
"195","2006-03",0.0393813634329379,2565.63628370971,2202.39996197546,880,0,-880
"196","2006-04",0.0393862197035763,2236.5557832773,1582.38493628013,551,0,-551
"197","2006-05",0.0393874233926019,2033.12710724559,701.416186668773,305,19,-286
"198","2006-06",0.0393760341015473,2908.48946618931,487.758966390454,71,61,-10
"199","2006-07",0.0393560804311503,3931.79231753474,348.030589819714,2,282,280
"200","2006-08",0.0393335789347298,3567.75693539522,296.509790416412,28,113,85
"201","2006-09",0.0392990792478416,2470.54962451194,436.766371509032,226,26,-200
"202","2006-10",0.0392657693053514,2135.84630303196,770.603708978993,571,0,-571
"203","2006-11",0.0392310734325561,2342.27679046498,1760.39897689769,839,0,-839
"204","2006-12",0.0391845574308832,2906.8417684415,2632.08953435451,1157,0,-1157
"205","2007-01",0.0391401679271715,3004.68081966778,3173.91175825343,1290,0,-1290
"206","2007-02",0.0391132684344074,3077.55547828954,2805.04924529567,864,0,-864
"207","2007-03",0.0391001311095922,2620.91111710493,1894.84430398306,695,0,-695
"208","2007-04",0.0390903386858425,2188.74251302929,1322.8068818331,548,0,-548
"209","2007-05",0.0390927746705346,2211.76815670885,817.203888049879,276,2,-274
"210","2007-06",0.0391001356440794,2760.81583022755,521.907239446343,105,63,-42
"211","2007-07",0.0391124947082493,3759.89140845726,363.829255148598,0,339,339
"212","2007-08",0.0391338363198688,3814.10997143408,330.756478958258,14,155,141
"213","2007-09",0.0391649401283048,2846.42310241831,416.222137756157,213,33,-180
"214","2007-10",0.0392106602188416,2321.61908926394,844.528665264314,565,0,-565
"215","2007-11",0.0392650134937078,2205.66123568462,1751.70533137048,850,0,-850
"216","2007-12",0.0393330759980785,2950.87118204336,2667.94140415297,1168,0,-1168
"217","2008-01",0.0394173538407918,3568.29627531943,3172.5591633005,1292,0,-1292
"218","2008-02",0.0394705435156727,3167.15827473136,3081.90438911405,994,0,-994
"219","2008-03",0.039488957523999,2947.57887654492,2258.98954704075,918,0,-918
"220","2008-04",0.0394796590411255,2416.32935721548,1885.11047611404,729,0,-729
"221","2008-05",0.0394283590533219,2167.15587055611,1109.99022903592,355,11,-344
"222","2008-06",0.0393455306017405,2469.71104248946,627.230494287778,179,55,-124
"223","2008-07",0.0392260728282435,3214.85236041986,397.36128407102,3,187,184
"224","2008-08",0.0390701845073503,3091.47242565038,351.661430925918,30,148,118
"225","2008-09",0.0388836342889077,2238.9767614412,419.673635876324,178,8,-170
"226","2008-10",0.0386676407015758,2092.09553965829,1177.43443773484,531,1,-530
"227","2008-11",0.0384215187271579,2394.10281651478,1876.21007871081,745,0,-745
"228","2008-12",0.0381501144622569,3407.84597396904,3145.76693968799,1209,0,-1209
"229","2009-01",0.0378427215648576,3898.91307045399,2972.24260075695,1183,0,-1183
"230","2009-02",0.0375736690079058,2868.85625638517,2367.60238198489,972,0,-972
"231","2009-03",0.037334600627968,2772.18512226584,2158.72367771168,911,0,-911
"232","2009-04",0.0371309507403236,2349.94176227888,1244.87299654917,614,0,-614
"233","2009-05",0.0369558917541826,2058.45783919214,706.681293996763,325,15,-310
"234","2009-06",0.0368110396299822,2380.22054128581,372.562161057252,137,21,-116
"235","2009-07",0.0366961171935682,2928.52384480453,368.596750756588,12,189,177
"236","2009-08",0.0366123927413137,2727.81185975287,359.705932525545,40,147,107
"237","2009-09",0.0365553438631415,2118.55020909417,399.565372646269,99,56,-43
"238","2009-10",0.0365327072079777,2212.89208584801,1267.02263335486,667,0,-667
"239","2009-11",0.0365444176651146,2376.96664348388,2233.71020646687,868,0,-868
"240","2009-12",0.0365970719959402,3272.82102487704,3398.19002233055,1317,0,-1317
"241","2010-01",0.0366772423804012,3824.01207473756,2624.06990529013,1063,0,-1063
"242","2010-02",0.0367479135247254,2856.97204703029,2050.72285117871,900,0,-900
"243","2010-03",0.0368103462014457,2650.08626896089,1817.89001894029,809,0,-809
"244","2010-04",0.0368607881127857,2201.18430064035,1412.69484362713,632,0,-632
"245","2010-05",0.0369001034726424,2229.33202853246,965.249979743462,513,0,-513
"246","2010-06",0.0369291339542896,2777.43705165449,563.669475780225,175,24,-151
"247","2010-07",0.0369426589117857,3377.09021606648,301.812843367686,36,144,108
"248","2010-08",0.0369413984972203,3459.64154857314,288.440743937052,53,122,69
"249","2010-09",0.0369259714449669,2268.60741048153,474.739954777958,158,13,-145
"250","2010-10",0.0368996257289494,2053.00380853562,891.00749019807,442,6,-436
"251","2010-11",0.0368709848085791,2291.72009321154,2313.83874110827,926,0,-926
"252","2010-12",0.0368334432443298,3372.39554697677,2803.01871390736,1093,0,-1093
"253","2011-01",0.036781255137047,3548.3770864806,2957.11731164963,1206,0,-1206
"254","2011-02",0.0367365548408925,2881.34322825216,2544.49317724277,1030,0,-1030
"255","2011-03",0.0366950778197555,2753.55275073896,1976.96199147662,844,0,-844
"256","2011-04",0.0366451897986734,2260.36134211824,1553.57050588888,723,0,-723
"257","2011-05",0.0365957515579796,2205.91768397731,896.768174708172,468,0,-468
"258","2011-06",0.0365476123302757,2627.14074707644,717.415925204134,216,13,-203
"259","2011-07",0.0364912873218564,3584.6733182129,426.089172687412,15,122,107
"260","2011-08",0.0364344398527008,3168.18038315511,338.471032912755,4,186,182
"261","2011-09",0.036372187964383,2201.95180555406,514.804222670046,87,46,-41
"262","2011-10",0.0363147871193638,1947.17836948321,1005.06975771683,503,4,-499
"263","2011-11",0.036261837701243,2278.36504341886,2266.44786221561,933,0,-933
"264","2011-12",0.0362085606907232,3123.6281065138,3011.11860909871,1169,0,-1169
"265","2012-01",0.0361538334391936,3110.65347175518,2822.86270208444,1078,0,-1078
"266","2012-02",0.0361248207978485,2750.02333945139,2281.98872319638,953,0,-953
"267","2012-03",0.036103539326262,2495.803109855,1830.81389450975,764,0,-764
"268","2012-04",0.0360987978017252,1987.59720194473,1088.11678330689,510,1,-509
"269","2012-05",0.0361103469101604,2147.95130417407,759.657978523364,373,2,-371
"270","2012-06",0.0361315368470012,2819.25020667416,457.248115795568,156,31,-125
"271","2012-07",0.0361655415388366,3909.2998368352,391.824412501618,5,257,252
"272","2012-08",0.0362096980042731,3004.54936287528,358.283772336863,5,207,202
"273","2012-09",0.0362651142464137,2229.59831685088,415.429989243625,100,11,-89
"274","2012-10",0.0363390570162692,1933.35171625319,1186.99757611123,547,0,-547
"275","2012-11",0.0364314639492653,2265.73381880109,1893.13526514284,758,0,-758
"276","2012-12",0.0365425612310457,2925.76059465932,2733.29839799165,1064,0,-1064
"277","2013-01",0.0366711662194594,3447.57524538503,3770.01949149669,1390,0,-1390
"278","2013-02",0.0367989765159433,2844.8137002216,2356.61749344132,934,0,-934
"279","2013-03",0.0369141364035031,2887.9430732706,1870.79011688452,784,0,-784
"280","2013-04",0.0370158536266161,2386.68268300358,1268.90387269082,605,0,-605
"281","2013-05",0.0371125544018994,2207.33177802688,616.192790217454,302,9,-293
"282","2013-06",0.0371884163973546,2383.44554323734,445.542176607353,117,75,-42
"283","2013-07",0.0372579230949262,3088.81369289376,322.919592330975,0,291,291
"284","2013-08",0.0373137888780468,3035.81494821174,289.024935322887,1,236,235
"285","2013-09",0.0373558687085894,2534.33850318596,442.691533569359,150,67,-83
"286","2013-10",0.0373907500452477,2113.98973771962,1320.37715217765,591,0,-591
"287","2013-11",0.0374175419556252,2454.38794716324,2177.80110453495,860,0,-860
"288","2013-12",0.0374441091717248,3317.0591009031,3493.46671246334,1298,0,-1298
"289","2014-01",0.0374600533198046,3747.10416988729,2970.24959549414,1116,0,-1116
"290","2014-02",0.0374845273658496,3185.10184734062,2310.09698550953,925,0,-925
"291","2014-03",0.0375149879048038,2833.62761530008,1758.498658458,755,0,-755
"292","2014-04",0.0375467707346199,2276.26428238167,1187.88730246858,584,0,-584
"293","2014-05",0.0375784124651452,2126.48727224093,577.757769060584,288,1,-287
"294","2014-06",0.0376124593444187,2454.31512198506,409.342808568595,125,17,-108
"295","2014-07",0.0376492894353997,2755.80561464267,365.864767977515,3,283,280
"296","2014-08",0.0376805748102487,2878.11693104688,358.151221380802,28,154,126
"297","2014-09",0.0377163729083777,2182.91593039111,415.279770550393,125,35,-90
"298","2014-10",0.0377566935628106,2019.29087096978,881.197716790859,391,0,-391
"299","2014-11",0.0378038906540679,2274.6031827674,2466.20133332136,926,0,-926
"300","2014-12",0.0378604427637748,3130.34257014505,2625.21767847168,1003,0,-1003
"301","2015-01",0.0379223167943779,3434.13064043604,2863.93999593815,1098,0,-1098
"302","2015-02",0.0379944010646806,2760.58697120308,1778.99426468287,734,0,-734
"303","2015-03",0.0380636852898751,2609.75245230055,1449.99390613576,639,0,-639
"304","2015-04",0.0381302427930676,1965.2873620912,1141.64318307559,559,0,-559
"305","2015-05",0.0381959967463796,1961.97789641987,591.291709203071,268,4,-264
"306","2015-06",0.038261474196164,2318.57691930218,341.925591246482,28,162,134
"307","2015-07",0.0383237432652621,3128.56932852817,323.801279700854,11,182,171
"308","2015-08",0.0383830389959751,2659.27927898684,240.21588233795,11,182,171
"309","2015-09",0.038442908037494,2528.05291245824,426.122228042438,143,26,-117
"310","2015-10",0.0385017844708317,1896.35968889737,663.602566103076,335,3,-332
"311","2015-11",0.0385698481126638,1918.01943406713,2413.36621448229,930,0,-930
"312","2015-12",0.0386351028027825,2917.20566937439,3149.71912121784,1144,0,-1144
"313","2016-01",0.0387126471945029,3334.79684579042,2939.4090540307,1129,0,-1129
"314","2016-02",0.0387852874415931,2566.16454024907,2130.25608766154,866,0,-866
"315","2016-03",0.038849245007915,2422.92458278184,1661.96919024701,726,0,-726
"316","2016-04",0.0389052254546261,1997.84146317302,845.804609238317,414,0,-414
"317","2016-05",0.0389532768475539,1800.65310867571,576.459205317248,301,0,-301
"318","2016-06",0.0389944661586079,2759.44530889351,378.251506400267,83,98,15
"319","2016-07",0.0390248757536011,3091.84294822309,336.997111932038,29,166,137
"320","2016-08",0.0390485280987493,2971.135187146,319.630406485548,9,175,166
"321","2016-09",0.0390654664204391,2305.63268636048,441.940161543932,143,14,-129
"322","2016-10",0.0390741628642162,1921.31556505052,931.159592257452,440,0,-440
"323","2016-11",0.0390837049917747,1922.43395004537,1697.12924006692,692,0,-692
"324","2016-12",0.0390906882149512,3111.46499441116,3752.75427816039,1331,0,-1331
"325","2017-01",0.0390890708756966,3214.88787116571,3937.19244715582,1410,0,-1410
"326","2017-02",0.03909493318929,2430.34058405056,2427.63449560699,920,0,-920
"327","2017-03",0.0390956913202109,2373.45087533642,1689.27270243828,701,0,-701
"328","2017-04",0.0390926403193234,1950.75159335144,1273.88228197526,615,0,-615
"329","2017-05",0.0390831412942096,1874.32452852855,702.774787149793,333,7,-326
"330","2017-06",0.0390694682103643,2556.4787229963,377.293704924599,100,56,-44
"331","2017-07",0.0390488083937404,3004.31143764243,325.763325990098,0,299,299
"332","2017-08",0.0390229305930745,2509.10070347703,332.801488350924,2,212,210
"333","2017-09",0.0389941856078725,2050.97788878779,524.198489119299,224,81,-143
"334","2017-10",0.038962701664026,2022.22167925218,1344.45406720343,611,0,-611
"335","2017-11",0.0389331819648971,2078.26295059623,1919.69337855498,788,0,-788
"336","2017-12",0.0389043483339748,2737.67525452039,3295.30883912104,1185,0,-1185
