"","Date","Real GDP per capita (millions of chained 2012 dollars per person)","Electricity Sale to Residential Consumers per capita (MJ/person)","Natural Gas Deliveries to Residential Consumers per capita (MJ/person)","HDD","CDD","DD"
"1","1990-01",0.0226870806415057,5177.50940531034,97.2732477074173,1242,0,-1242
"2","1990-02",0.0226735603682585,4291.29913584979,76.7294560511362,1275,0,-1275
"3","1990-03",0.0226513750007764,4194.99212918596,73.1414932838183,1092,0,-1092
"4","1990-04",0.0226180766969367,3748.43566078065,59.7383847185194,701,0,-701
"5","1990-05",0.0225776355960874,3374.48211464048,42.7825776890287,444,0,-444
"6","1990-06",0.0225284654474836,3207.07245698797,26.7289373706939,109,19,-90
"7","1990-07",0.0224711826382964,3527.00071586338,17.8124848066996,23,126,103
"8","1990-08",0.0224054163297868,3785.98708533202,16.9150838913462,26,130,104
"9","1990-09",0.0223314492463235,3526.41163690362,19.5779172897353,232,4,-228
"10","1990-10",0.0222495710760945,3137.91259027547,24.0178136060784,479,0,-479
"11","1990-11",0.022161388070856,3501.14061156122,49.7986525477917,828,0,-828
"12","1990-12",0.0220653831927737,4087.83847416737,73.7856441845071,1128,0,-1128
"13","1991-01",0.0219618836536737,4774.66206569036,94.2051396143719,1514,0,-1514
"14","1991-02",0.021871819198547,4290.49915083675,93.2898246769696,1175,0,-1175
"15","1991-03",0.0217964466154065,4025.61783722279,83.4979199212935,1022,0,-1022
"16","1991-04",0.0217342550302541,3593.19801324835,67.4933626460363,662,0,-662
"17","1991-05",0.021684844402029,3194.43124719792,40.8407743514284,282,6,-276
"18","1991-06",0.021648132823852,3256.71408669335,28.4028719164489,100,59,-41
"19","1991-07",0.0216281497804666,3653.11884245601,21.2994418465682,29,110,81
"20","1991-08",0.0216217012813283,3672.61877555234,16.860094004525,32,117,85
"21","1991-09",0.0216292638923946,3451.43828164125,23.0697835842282,269,6,-263
"22","1991-10",0.0216514405643439,3160.52573688707,31.9420638255856,517,0,-517
"23","1991-11",0.0216886446930852,3521.69051852058,49.6905188906345,827,0,-827
"24","1991-12",0.0217411707038351,4222.44499654434,90.521365969538,1374,0,-1374
"25","1992-01",0.0218080370782978,4870.52565969215,113.617898229566,1475,0,-1475
"26","1992-02",0.0218677145753932,4516.51991734064,123.403175818213,1319,0,-1319
"27","1992-03",0.0219194058393524,4216.20292083183,108.322676616327,1215,0,-1215
"28","1992-04",0.0219626119004594,3797.48628718831,85.2398011029911,793,0,-793
"29","1992-05",0.0219982093174371,3349.70452630185,58.6013916972417,418,13,-405
"30","1992-06",0.0220259341256408,3195.84654238492,32.849938117535,104,15,-89
"31","1992-07",0.02204611680637,3367.73835051078,21.3056859226203,74,28,-46
"32","1992-08",0.0220579105411345,3363.68633441587,19.5264974033137,42,45,3
"33","1992-09",0.0220627115181685,3361.65273390859,15.0855581083597,229,12,-217
"34","1992-10",0.0220601825594213,3314.96609673614,36.374229427003,644,0,-644
"35","1992-11",0.0220508675966477,3647.51575206082,62.0873002564411,932,0,-932
"36","1992-12",0.0220346921739856,4327.88442968991,98.4279059643078,1243,0,-1243
"37","1993-01",0.0220109919606823,4794.81323141878,127.652937841893,1444,0,-1444
"38","1993-02",0.0219962811295737,4480.57971380755,135.60055155474,1522,0,-1522
"39","1993-03",0.0219899301442918,4458.80787415275,101.016647897169,1193,0,-1193
"40","1993-04",0.0219911250559145,3837.76645288235,62.9020680707177,705,0,-705
"41","1993-05",0.0220004229844995,3171.17442451045,33.6604660738115,347,0,-347
"42","1993-06",0.0220175259587848,3102.10634219684,26.5701125996419,125,35,-90
"43","1993-07",0.0220426436312641,3730.13607063453,19.4823021678575,25,102,77
"44","1993-08",0.0220754945008519,3661.39073166588,19.4800494593612,15,93,78
"45","1993-09",0.0221168882160192,3603.32006114154,23.9056840833402,223,9,-214
"46","1993-10",0.0221666540363808,3298.78248984695,54.8928737599216,686,0,-686
"47","1993-11",0.0222256147700199,3600.34315255589,77.9159955313481,870,0,-870
"48","1993-12",0.0222932287076339,4155.38791534584,114.228719962853,1234,0,-1234
"49","1994-01",0.022369210826671,5006.97726367721,151.439636167726,1774,0,-1774
"50","1994-02",0.0224414760208044,4676.00441159969,119.579253493605,1427,0,-1427
"51","1994-03",0.0225082390014597,4480.99643624421,102.764913330406,1109,0,-1109
"52","1994-04",0.0225687453480409,3695.12946759305,61.1325609802719,727,0,-727
"53","1994-05",0.022625354741132,3205.15072758068,43.4183763840604,446,0,-446
"54","1994-06",0.0226763355120623,3257.67796242019,28.3573465356561,78,67,-11
"55","1994-07",0.0227222261606878,4113.91085985604,20.3833751599091,0,181,181
"56","1994-08",0.0227630623035565,4105.9309546986,19.4983949150022,47,59,12
"57","1994-09",0.0227988935345378,3486.22810205955,26.59020058205,243,0,-243
"58","1994-10",0.0228301529392907,3227.32521181794,45.2063289938703,536,0,-536
"59","1994-11",0.0228573028763938,3362.46003364799,69.145781302563,793,0,-793
"60","1994-12",0.0228799600358231,4061.62089029109,103.730144955057,1191,0,-1191
"61","1995-01",0.0228979428279386,4717.59692287327,115.269152039917,1332,0,-1332
"62","1995-02",0.0229269481443743,4331.29139579832,123.260754027152,1379,0,-1379
"63","1995-03",0.0229667077962769,4122.34338808146,99.3236965054719,1072,0,-1072
"64","1995-04",0.0230161393399973,3524.46537145888,71.8304981372944,816,0,-816
"65","1995-05",0.0230767358745058,3207.40270608601,42.5644109761069,419,0,-419
"66","1995-06",0.0231472021836064,3459.49774625589,24.8263721954182,81,64,-17
"67","1995-07",0.0232279002378241,4009.02893230112,21.2760867722605,9,139,130
"68","1995-08",0.0233192037460748,4295.72369605171,21.2715824565519,36,95,59
"69","1995-09",0.0234205487419672,3393.87296001762,27.4682470232926,313,3,-310
"70","1995-10",0.0235325912094066,3190.25544888615,42.5183557837129,450,0,-450
"71","1995-11",0.0236565023970973,3628.74909739379,85.8974202875013,955,0,-955
"72","1995-12",0.0237918670109095,4646.51608135265,133.677457397258,1386,0,-1386
"73","1996-01",0.0239383529468594,5136.1360429333,140.716504860251,1513,0,-1513
"74","1996-02",0.0240481526000165,4425.86148909553,126.51867925753,1325,0,-1325
"75","1996-03",0.0241208027372007,4140.32320922175,121.172731892165,1167,0,-1167
"76","1996-04",0.024156116006586,3674.98487864468,71.6186543130337,716,0,-716
"77","1996-05",0.0241550563582289,3293.59323235008,43.3113603514098,442,0,-442
"78","1996-06",0.0241168811970082,3498.94729640515,25.6248988510729,104,22,-82
"79","1996-07",0.0240420990460597,3908.68403129115,22.0833474452337,25,44,19
"80","1996-08",0.0239301135605243,3841.45354500334,20.3097390217116,27,69,42
"81","1996-09",0.023781738417863,3535.37631886093,24.716733019008,211,13,-198
"82","1996-10",0.023597370085052,3472.02132640814,59.1256604428471,615,0,-615
"83","1996-11",0.023376719208703,3705.24436353304,92.632756202852,964,0,-964
"84","1996-12",0.0231211774327766,4509.70576072787,105.84302594021,1065,0,-1065
"85","1997-01",0.0228296522121619,4915.60467233501,146.388262898424,1486,0,-1486
"86","1997-02",0.0226851454327106,4217.52030577707,117.266432636116,1213,0,-1213
"87","1997-03",0.0226869264623691,3975.35417002763,125.178191733007,1224,0,-1224
"88","1997-04",0.0228345138455358,3719.63541103905,74.9142235976136,786,0,-786
"89","1997-05",0.0231286850770752,3261.24805794647,49.3448508631731,502,0,-502
"90","1997-06",0.0235686539393039,3656.26283122059,29.9524054844212,124,48,-76
"91","1997-07",0.0241545619218641,4035.3881629399,18.4955170687707,16,105,89
"92","1997-08",0.0248855044975899,3970.2956995148,22.8926854682202,48,56,8
"93","1997-09",0.0257626693529676,3532.60313181966,26.4074431552396,238,0,-238
"94","1997-10",0.0267862185997371,3387.45602513544,58.0818256245601,616,0,-616
"95","1997-11",0.0279564835835839,3700.66430697909,94.142700137332,956,0,-956
"96","1997-12",0.0292735073588708,4690.49176427226,124.914625697712,1279,0,-1279
"97","1998-01",0.0307360448786874,4887.49554780882,133.686531570508,1363,0,-1363
"98","1998-02",0.0320603649947141,4140.48777849454,111.686235619434,1070,0,-1070
"99","1998-03",0.0332453224511287,4025.4041767196,105.52182727573,1028,0,-1028
"100","1998-04",0.0342888542231276,3508.21546595477,62.4266254627317,653,0,-653
"101","1998-05",0.0351928267876964,3360.25830822808,39.5624841611785,254,7,-247
"102","1998-06",0.0359570047351344,3387.81489254877,27.251934547308,164,14,-150
"103","1998-07",0.0365815454679616,4117.91354593187,19.3387832698952,20,104,84
"104","1998-08",0.0370659194527085,4287.02014432589,21.974381755414,25,97,72
"105","1998-09",0.0374115122414676,3867.02860174944,23.7315308853834,191,4,-187
"106","1998-10",0.0376182954789366,3492.13803846186,54.4945723788639,573,0,-573
"107","1998-11",0.0376867381567043,3735.52866132363,83.5033951618091,854,0,-854
"108","1998-12",0.037617289849207,4481.00185531051,116.037436348471,1114,0,-1114
"109","1999-01",0.0374080653739451,5119.82844929339,145.06252827383,1470,0,-1470
"110","1999-02",0.0372336342732547,4318.90915507853,116.925663121831,1136,0,-1136
"111","1999-03",0.0370911272952927,4299.53635237981,115.138825680846,1006,0,-1006
"112","1999-04",0.0369787083237937,3659.44848897674,66.7635592116616,661,0,-661
"113","1999-05",0.0368979879441769,3440.59819234967,35.1125991058842,289,4,-285
"114","1999-06",0.0368486580857569,3725.44946358593,22.800896116363,54,91,37
"115","1999-07",0.0368310484195668,4722.13068558842,18.3940256280978,8,164,156
"116","1999-08",0.0368448543610938,4612.27060788761,21.8664222906544,38,71,33
"117","1999-09",0.036890715875149,4083.42746441519,23.5772239978504,111,68,-43
"118","1999-10",0.0369684269440228,3604.31458848638,60.1423400498287,625,0,-625
"119","1999-11",0.0370789460550729,3924.44123918638,80.8987814141445,751,0,-751
"120","1999-12",0.0372216302111243,4460.44844952265,131.064530578335,1142,0,-1142
"121","2000-01",0.0373945818033433,4986.62212554153,174.908951903392,1491,0,-1491
"122","2000-02",0.037554104180427,4707.33455189357,105.411176465719,1294,0,-1294
"123","2000-03",0.0376981006286965,4171.59103231578,106.068039232748,952,0,-952
"124","2000-04",0.0378250204379146,3561.41786718045,76.6104765550283,709,0,-709
"125","2000-05",0.0379388368201752,3541.83399016995,42.1136154013221,425,0,-425
"126","2000-06",0.0380367838869072,3929.95848153627,26.6067754297287,149,33,-116
"127","2000-07",0.0381186432719685,4202.62180581573,23.1456891009195,37,32,-5
"128","2000-08",0.0381865274102747,4358.53586382911,22.2663918354868,41,42,1
"129","2000-09",0.0382393457279931,3773.87389159097,27.3827674903523,264,13,-251
"130","2000-10",0.0382779423026338,3542.55356008304,53.8775852129886,574,0,-574
"131","2000-11",0.0383032104351714,3835.1274993658,82.0687427244551,823,0,-823
"132","2000-12",0.0383139929945814,4900.07738952142,150.433084968413,1382,0,-1382
"133","2001-01",0.0383117429231481,5091.68560110201,149.587164586907,1511,0,-1511
"134","2001-02",0.0383172284606326,4186.08700692294,131.638117233254,1311,0,-1311
"135","2001-03",0.0383293374812362,4569.64408490251,122.227271001882,1197,0,-1197
"136","2001-04",0.038347781029934,3760.36338860462,77.7692417048341,746,0,-746
"137","2001-05",0.0383734995011148,3509.98287190139,32.4682189357997,321,7,-314
"138","2001-06",0.0384052484673215,4116.98916661621,18.7916968936602,85,85,0
"139","2001-07",0.0384440899321634,4474.23876411363,21.3463694417388,45,61,16
"140","2001-08",0.0384893103121389,5003.2824225178,21.3367915087708,20,137,117
"141","2001-09",0.0385409290516591,3959.45954779809,27.296631797702,185,21,-164
"142","2001-10",0.0386028326571298,3680.54156317698,46.0396216329139,526,0,-526
"143","2001-11",0.0386701059081703,3666.14229375519,51.9757267153392,770,0,-770
"144","2001-12",0.0387449397222057,4373.40630658167,112.397398200296,1061,0,-1061
"145","2002-01",0.0388274145343633,4686.56550857492,127.633668965892,1284,0,-1284
"146","2002-02",0.0389036941381367,4304.75252537007,124.993075922131,1189,0,-1189
"147","2002-03",0.0389748020923296,4123.83249979139,121.510408596075,1095,0,-1095
"148","2002-04",0.0390386215669689,3636.77605797408,79.8186812212462,712,0,-712
"149","2002-05",0.0390955804663953,3636.54292073982,44.123948560684,476,0,-476
"150","2002-06",0.039145524293751,3798.29941728622,27.1336722690707,197,25,-172
"151","2002-07",0.0391898168776514,5048.98652475606,22.8780054320564,45,89,44
"152","2002-08",0.0392273841132842,5539.76682357246,23.7085167072899,35,122,87
"153","2002-09",0.0392582211976875,4465.39815438816,23.6914864578661,178,33,-145
"154","2002-10",0.0392834283088329,3791.75074026286,59.1872600495568,659,2,-657
"155","2002-11",0.0393033552871133,3952.80174167289,92.9459544705029,973,0,-973
"156","2002-12",0.0393189035847229,5023.66008974161,147.776357751711,1303,0,-1303
"157","2003-01",0.039328379421191,5338.88994321229,181.441699763353,1659,0,-1659
"158","2003-02",0.0393538404908157,4725.54412162156,161.104270931382,1395,0,-1395
"159","2003-03",0.0393929199584844,4739.99692533178,145.851924899447,1180,0,-1180
"160","2003-04",0.0394445401398115,4016.37696038341,96.0658206033894,812,0,-812
"161","2003-05",0.0395087908751693,3783.44936478265,50.5382312194465,438,0,-438
"162","2003-06",0.0395812809737678,3845.03443113072,26.0972021110875,125,52,-73
"163","2003-07",0.0396658773856225,5226.6113564162,23.5589137045365,14,95,81
"164","2003-08",0.039763849234975,5505.52676748867,24.387976894042,35,111,76
"165","2003-09",0.039875816136919,4142.93388514724,25.2174972705625,147,5,-142
"166","2003-10",0.0400011652700372,3886.7258420264,52.9346404551714,572,0,-572
"167","2003-11",0.0401403665390815,3999.29886610901,88.1918080406108,817,0,-817
"168","2003-12",0.0402945266174613,4914.23300546846,144.424082413936,1219,0,-1219
"169","2004-01",0.0404625366880405,5647.10764510496,198.114347565202,1735,0,-1735
"170","2004-02",0.0406122298329247,4764.36359805496,151.911685566422,1299,0,-1299
"171","2004-03",0.0407421084039081,4400.37012481892,132.58000495747,1066,0,-1066
"172","2004-04",0.040850266897852,3946.46194907909,85.5674754425382,712,0,-712
"173","2004-05",0.040937993252958,3833.35767631373,39.4173061263139,370,0,-370
"174","2004-06",0.0410072282353953,4299.87479467322,26.8307588045021,201,12,-189
"175","2004-07",0.0410564918027913,4775.87340671451,23.4710428402966,29,47,18
"176","2004-08",0.0410854937957331,5036.20154037933,23.4648635435637,39,75,36
"177","2004-09",0.0410951473462145,4371.54660154767,26.8101592385641,216,0,-216
"178","2004-10",0.0410848412670271,3956.02032637656,51.9311168210984,553,0,-553
"179","2004-11",0.0410568735105541,4111.30118150171,87.0917781158142,867,0,-867
"180","2004-12",0.041010231666572,5256.66823306087,149.870160060981,1319,0,-1319
"181","2005-01",0.0409441870052681,5176.82620233496,174.119119604178,1588,0,-1588
"182","2005-02",0.0408935549396573,4473.38234675145,145.641220941569,1238,0,-1238
"183","2005-03",0.0408539522970548,4687.386960707,143.109222655117,1190,0,-1190
"184","2005-04",0.040824514862574,3862.25888962419,71.958441256546,654,0,-654
"185","2005-05",0.0408064594817139,3786.7045459498,52.7016171244157,501,0,-501
"186","2005-06",0.0408014393116484,4676.82755506423,25.0905815912154,104,94,-10
"187","2005-07",0.0408077331517525,5777.47542083344,23.4121523998447,14,104,90
"188","2005-08",0.0408262971842517,5803.30256424428,25.0782041894878,14,107,93
"189","2005-09",0.0408565672392188,4673.40100296242,23.4000731140483,122,21,-101
"190","2005-10",0.0408992285431761,4114.52675198365,49.2940763313465,496,0,-496
"191","2005-11",0.0409569235896475,4180.90633942379,85.2028448207774,820,0,-820
"192","2005-12",0.0410250572072329,5160.19616490755,141.968839732439,1279,0,-1279
"193","2006-01",0.0411065183567463,5141.40759529641,127.74250937006,1228,0,-1228
"194","2006-02",0.0411758869312438,4261.52142962036,138.565406985437,1207,0,-1207
"195","2006-03",0.0412347566690868,4614.15668266763,118.510629301001,1043,0,-1043
"196","2006-04",0.0412807892152177,3599.89755431763,72.5947460915922,635,0,-635
"197","2006-05",0.0413153736391552,3711.84780271035,43.3825979973155,339,3,-336
"198","2006-06",0.0413368434690216,4522.02108488097,15.0142171370107,83,31,-52
"199","2006-07",0.0413459509687949,5743.82331704951,25.0189429832859,1,143,142
"200","2006-08",0.0413438309510064,5425.78864127458,22.5133628271348,93,40,-53
"201","2006-09",0.0413287067255759,3986.57324129148,25.0103299807542,227,0,-227
"202","2006-10",0.0413030710254291,3780.33376655729,50.0137902375609,568,0,-568
"203","2006-11",0.0412664463598229,4098.05980257156,70.0119060946307,724,0,-724
"204","2006-12",0.0412168555184193,4840.97218093231,114.172152680331,1074,0,-1074
"205","2007-01",0.041156948868638,4881.4445157428,150.829401726517,1376,0,-1376
"206","2007-02",0.0411052481204716,5009.3315095253,172.484571866541,1404,0,-1404
"207","2007-03",0.0410610636333101,4530.7260762385,134.978564246675,1130,0,-1130
"208","2007-04",0.0410224237126596,3889.31437377203,91.6408047866576,789,0,-789
"209","2007-05",0.0409910367894185,3848.05041709248,42.482240137274,384,3,-381
"210","2007-06",0.0409655201191096,4350.88868678968,27.4835079219923,131,28,-103
"211","2007-07",0.0409458970512796,5176.73122560163,29.9751895216158,57,67,10
"212","2007-08",0.0409329391360444,5534.09022476377,15.8162195949809,72,62,-10
"213","2007-09",0.040926804882768,4422.17328846626,24.9660684939573,192,15,-177
"214","2007-10",0.0409284335374896,4057.415638887,38.2707305097663,442,1,-441
"215","2007-11",0.0409366848770721,4130.16135804738,88.1623127757494,929,0,-929
"216","2007-12",0.0409525380626157,5202.13306306812,154.652476772557,1358,0,-1358
"217","2008-01",0.0409764777548557,5118.42329171538,148.7879100646,1363,0,-1363
"218","2008-02",0.0409904312443236,4753.98481583244,147.092581132371,1285,0,-1285
"219","2008-03",0.0409936716583773,4687.07450793752,138.75902850357,1180,0,-1180
"220","2008-04",0.0409875360473336,3866.99245356926,73.1127648479403,662,0,-662
"221","2008-05",0.0409692560144708,3598.03642010019,40.708161607613,403,0,-403
"222","2008-06",0.0409408205660438,4222.36646739371,20.7697131920574,101,28,-73
"223","2008-07",0.0409012188101854,5506.61455206794,20.7708907179836,6,109,103
"224","2008-08",0.0408504551912942,4921.27483450857,24.0966904958684,62,13,-49
"225","2008-09",0.0407896197921964,4313.33531748187,27.4251506189181,233,11,-222
"226","2008-10",0.0407189277500036,3537.9037231692,50.7077680124825,613,0,-613
"227","2008-11",0.0406382232460707,4158.28305052483,89.8070661485551,864,0,-864
"228","2008-12",0.0405484477310177,4888.02891747618,133.104200165778,1278,0,-1278
"229","2009-01",0.0404474556529815,5455.48496727101,201.415331774996,1661,0,-1661
"230","2009-02",0.0403625926626422,4882.2055558501,190.666980867737,1244,0,-1244
"231","2009-03",0.0402922341786489,4448.46664402756,159.065378524983,1139,0,-1139
"232","2009-04",0.0402375163165992,4020.7156577266,105.779019736297,628,0,-628
"233","2009-05",0.0401970818843099,3599.41816807457,54.9704843174951,381,3,-378
"234","2009-06",0.0401712742211933,3786.10602927659,39.1393060228761,181,7,-174
"235","2009-07",0.0401600455069826,4440.19105488099,29.9699967938536,73,26,-47
"236","2009-08",0.0401636599486565,5618.2248013837,21.6355917268057,52,111,59
"237","2009-09",0.0401811772934027,4237.43905014865,24.1177672515132,272,0,-272
"238","2009-10",0.0402141894294729,3942.63863434992,42.3841086296198,676,0,-676
"239","2009-11",0.0402626709181079,3931.23577547032,83.0380353417371,755,0,-755
"240","2009-12",0.0403279752902226,4818.49534113852,117.808138897106,1229,0,-1229
"241","2010-01",0.0404072724216814,5469.73246056609,181.50014608957,1327,0,-1327
"242","2010-02",0.0404726616194575,5162.51468328617,154.007764134085,1070,0,-1070
"243","2010-03",0.0405244470393859,4549.2213018586,119.135810973512,872,0,-872
"244","2010-04",0.040561879292065,3851.97480126608,88.4623394409672,549,0,-549
"245","2010-05",0.0405851645544119,3928.64619944492,51.2280064223575,295,17,-278
"246","2010-06",0.0405944970978397,4833.35768897514,28.9049946323634,122,22,-100
"247","2010-07",0.040588798740727,6220.75833841697,22.2891650023313,19,171,152
"248","2010-08",0.0405682236777313,5690.89550463984,23.1073841479525,36,75,39
"249","2010-09",0.0405328977186022,4981.21942965387,25.5773716881391,193,44,-149
"250","2010-10",0.04048348895486,4044.24272059099,52.798495447234,563,0,-563
"251","2010-11",0.0404217822625784,4119.83716589661,104.775032508155,845,0,-845
"252","2010-12",0.0403463732409173,5203.93574346578,167.499297040075,1209,0,-1209
"253","2011-01",0.0402560301278773,5441.01882037044,222.008466156987,1462,0,-1462
"254","2011-02",0.0401762456455411,5006.73109190191,193.169802809643,1296,0,-1296
"255","2011-03",0.0401061400129854,4581.27597376555,160.187077213775,1092,0,-1092
"256","2011-04",0.0400432946243468,4192.11625359027,110.663100090465,694,0,-694
"257","2011-05",0.0399895668597011,3694.1080536624,58.6433218682702,359,4,-355
"258","2011-06",0.039945140754258,4379.58807309664,37.172923297419,141,13,-128
"259","2011-07",0.0399080367972208,5734.0735785742,27.2616618570713,11,133,122
"260","2011-08",0.0398798575991027,5373.56381765697,20.6533321463272,25,51,26
"261","2011-09",0.0398595779379486,4572.93165630252,30.5660924329713,155,17,-138
"262","2011-10",0.0398493484862826,3902.69087608996,51.2174227002161,498,0,-498
"263","2011-11",0.0398490884144687,3953.17182682147,94.997152693357,741,0,-741
"264","2011-12",0.0398577897639035,4667.18730039897,156.942648584647,1117,0,-1117
"265","2012-01",0.0398752090146507,5167.68432516352,210.614114075251,1333,0,-1333
"266","2012-02",0.0398880928329735,4473.42570806831,182.528087671642,1166,0,-1166
"267","2012-03",0.0398926334898024,4273.7307065194,130.488847208767,901,0,-901
"268","2012-04",0.0398907023251577,3702.87327252754,85.0631603877609,622,0,-622
"269","2012-05",0.039882250560286,3781.50325169447,55.3319075261418,309,2,-307
"270","2012-06",0.0398658685583504,4393.52419082706,43.7689849726806,158,33,-125
"271","2012-07",0.0398422366092049,5813.20767505913,28.0775950130508,7,118,111
"272","2012-08",0.0398107970126118,5935.89130548994,26.4250537107393,6,105,99
"273","2012-09",0.0397717955142631,4694.60409355334,33.8557048694112,231,4,-227
"274","2012-10",0.0397267801446066,3866.53273377634,66.0593338546625,465,0,-465
"275","2012-11",0.0396757400953463,4131.5511109057,148.637000130082,904,0,-904
"276","2012-12",0.0396187222804783,4827.90642631722,218.013393518103,1155,0,-1155
"277","2013-01",0.0395554753996411,5343.03379654512,279.972698988969,1398,0,-1398
"278","2013-02",0.0395078438950577,4853.88441984295,242.009262704412,1176,0,-1176
"279","2013-03",0.039473354949449,4751.90643983865,198.247819879657,1009,0,-1009
"280","2013-04",0.039451855979042,4015.56621948041,136.300234716809,711,0,-711
"281","2013-05",0.0394450947214749,3675.48091947823,66.0876023845439,369,5,-364
"282","2013-06",0.0394498033479847,4480.50169607232,39.6510300074168,125,45,-80
"283","2013-07",0.0394689707002499,6242.35061657961,30.5630705162469,15,149,134
"284","2013-08",0.0395010870147745,5231.42280646639,28.0826714671766,37,38,1
"285","2013-09",0.0395461116030821,4591.56696031927,35.5119120254154,228,20,-208
"286","2013-10",0.0396053908864814,3816.68151686315,64.4084789078799,507,0,-507
"287","2013-11",0.03967872787402,4068.59989205781,160.99802696623,918,0,-918
"288","2013-12",0.0397677433963721,5119.45788749158,279.031097227564,1384,0,-1384
"289","2014-01",0.0398702692154812,5700.07790760928,347.501579157649,1461,0,-1461
"290","2014-02",0.0399637926483344,5113.76080552344,297.950029037441,1294,0,-1294
"291","2014-03",0.0400478016077805,4880.84148263699,299.585933161971,1328,0,-1328
"292","2014-04",0.0401213309429643,3918.03456874226,170.007085499119,729,0,-729
"293","2014-05",0.0401840796692216,3687.69004505502,92.4285159519953,371,0,-371
"294","2014-06",0.0402365883754094,4037.04640930645,45.3887015625255,101,19,-82
"295","2014-07",0.0402789426780717,5350.88947246045,33.8357557198556,4,101,97
"296","2014-08",0.0403093907013958,4805.34159047184,33.8355919048257,33,39,6
"297","2014-09",0.0403300556969968,4592.92922040749,44.5651533312508,244,29,-215
"298","2014-10",0.0403409438910221,3684.16256787702,86.6595740223985,454,0,-454
"299","2014-11",0.0403425543496878,3964.5427560193,205.528223184029,924,0,-924
"300","2014-12",0.0403354090856893,4637.65100905871,288.941520734648,1102,0,-1102
"301","2015-01",0.0403186516771132,5427.87150144796,434.323380072495,1538,0,-1538
"302","2015-02",0.0403108297724568,5313.80964894392,436.894628895094,1580,0,-1580
"303","2015-03",0.0403092106284188,4874.19856595447,333.71404749613,1269,0,-1269
"304","2015-04",0.0403138207887131,3941.54181535291,185.05123645416,735,0,-735
"305","2015-05",0.0403250731415737,3589.8840528481,78.4877014517311,272,16,-256
"306","2015-06",0.0403430850717532,4104.85277901014,58.6617245897035,190,10,-180
"307","2015-07",0.0403672460737398,5147.87273042656,40.4845122794933,32,74,42
"308","2015-08",0.040397608807947,5540.84147477801,39.6560005664152,10,100,90
"309","2015-09",0.0404349204008955,4999.93404010127,39.6524780104095,117,52,-65
"310","2015-10",0.0404788525156144,3797.65962689623,119.768230810125,610,0,-610
"311","2015-11",0.0405315501488592,3668.45166945819,203.169945465124,781,0,-781
"312","2015-12",0.0405904878997681,4293.75374006003,260.114648372846,969,0,-969
"313","2016-01",0.0406588520579843,4844.62454013349,359.984654685651,1295,0,-1295
"314","2016-02",0.0407269872386756,4512.81060518512,320.306341682643,1152,0,-1152
"315","2016-03",0.0407940913217285,4128.14891681023,272.375870949439,1001,0,-1001
"316","2016-04",0.0408603082709295,3697.86797154189,210.42722561981,742,0,-742
"317","2016-05",0.0409256426060373,3510.39990159178,112.200297442325,339,3,-336
"318","2016-06",0.0409903151870301,4049.61937777073,49.4866897894641,121,14,-107
"319","2016-07",0.0410534847882713,5394.84125009505,41.2257982577604,26,134,108
"320","2016-08",0.0411159998284198,6124.15173496579,36.2662441450145,2,123,121
"321","2016-09",0.0411778632398338,5076.28429513056,46.1400193359538,110,35,-75
"322","2016-10",0.0412387396912448,3725.50170985536,109.538491411251,466,0,-466
"323","2016-11",0.041300580677514,3647.86862551794,188.53070222174,774,0,-774
"324","2016-12",0.0413626572153226,4582.37850747862,369.507174087595,1270,0,-1270
"325","2017-01",0.0414236592999079,5581.21111642744,367.704299769109,1237,0,-1237
"326","2017-02",0.0414808013002358,4853.6226989778,324.811752889532,1139,0,-1139
"327","2017-03",0.0415313656056281,4932.94051394595,350.177215963153,1218,0,-1218
"328","2017-04",0.0415756420099133,4290.67864310003,193.10474277639,624,0,-624
"329","2017-05",0.0416130596923307,4141.30027496246,110.892645238624,409,9,-400
"330","2017-06",0.0416441219673793,4877.63146588461,62.4063455522456,122,41,-81
"331","2017-07",0.041668215496993,5823.94109028958,42.6835472700375,27,73,46
"332","2017-08",0.041685732673416,5807.62345689832,44.30908291609,60,55,-5
"333","2017-09",0.0416971977788754,4951.13347679553,47.5744810997057,107,34,-73
"334","2017-10",0.0417026459603377,4245.78467617286,69.6975595543833,356,0,-356
"335","2017-11",0.0417031279258672,4390.65074457479,216.407115944231,892,0,-892
"336","2017-12",0.0416983691698326,5313.11065403572,426.141060470518,1404,0,-1404
