"","Date","Real GDP per capita (millions of chained 2012 dollars per person)","Electricity Sale to Residential Consumers per capita (MJ/person)","Natural Gas Deliveries to Residential Consumers per capita (MJ/person)","HDD","CDD","DD"
"1","1990-01",0.024673939818502,9064.8401761023,5242.20425926774,1011,0,-1011
"2","1990-02",0.0246605293448926,6070.9810203206,4464.99967690294,980,0,-980
"3","1990-03",0.0246518732064939,5917.84130115538,3627.59107566284,757,0,-757
"4","1990-04",0.0246417068159469,5421.95727397063,2726.65065642647,494,24,-470
"5","1990-05",0.0246400829695828,4832.40106324948,1566.25350344953,231,7,-224
"6","1990-06",0.0246429238405294,5349.86294466917,889.749006943083,13,249,236
"7","1990-07",0.0246517591807911,7494.83946429959,725.546715208397,6,291,285
"8","1990-08",0.0246656018599606,7651.15614594861,650.170461000135,1,284,283
"9","1990-09",0.0246851369516244,7358.68339094377,709.403579453447,72,180,108
"10","1990-10",0.0247110794909193,5163.7599461603,1299.98765501065,399,6,-393
"11","1990-11",0.0247475870135155,5106.85766633539,2370.06051527516,704,0,-704
"12","1990-12",0.0247907475365621,6062.59266205481,4283.05931167256,1349,0,-1349
"13","1991-01",0.0248414253729828,7507.25444307853,6513.51609382388,1452,0,-1452
"14","1991-02",0.0248986797529999,6941.62160470607,4481.66222869406,817,0,-817
"15","1991-03",0.0249658799520834,6538.78398256135,3568.42572131838,744,0,-744
"16","1991-04",0.0250390367926017,5245.82255821864,2137.2654786479,389,12,-377
"17","1991-05",0.0251170598976201,5093.30705063478,1527.93049992078,139,113,-26
"18","1991-06",0.0251996972783462,6626.3131282506,794.786546504997,0,278,278
"19","1991-07",0.0252978785699832,7934.4430323717,695.986216767458,0,337,337
"20","1991-08",0.0254029678877553,7840.03143445643,650.476719047692,0,284,284
"21","1991-09",0.0255162424365284,6413.31347657128,740.048751681016,125,142,17
"22","1991-10",0.0256393354339663,5205.11898437915,1405.46036433449,433,2,-431
"23","1991-11",0.0257733644720044,5630.1763881875,3539.36295839297,1051,0,-1051
"24","1991-12",0.025919114512843,6853.54374240487,4474.92041220073,1041,0,-1041
"25","1992-01",0.0260738248212004,8267.88288753484,4666.35959539468,1013,0,-1013
"26","1992-02",0.0262062952933805,7225.14178254015,4050.55362384234,825,0,-825
"27","1992-03",0.0263143832149494,6123.13842098797,3198.70566167261,702,0,-702
"28","1992-04",0.0263967616429554,5969.75945196834,2554.07875879737,478,4,-474
"29","1992-05",0.0264559253969039,5071.87188540807,1371.27294116651,164,49,-115
"30","1992-06",0.0264911978027432,5347.69594155143,889.388498660567,24,92,68
"31","1992-07",0.026503549642292,7664.8896140049,709.834598372976,7,158,151
"32","1992-08",0.0264906802548033,7715.35579733222,665.966822361233,36,128,92
"33","1992-09",0.0264565055338884,6214.62853007206,742.042144460673,102,67,-35
"34","1992-10",0.0264001218765667,5251.97050037039,1373.56070915482,401,6,-395
"35","1992-11",0.0263230508193768,5501.19437343653,3084.50200616344,954,0,-954
"36","1992-12",0.0262250912948084,7746.28519238429,4789.31916990416,1239,0,-1239
"37","1993-01",0.0261044222024442,8228.29612453281,6090.004515027,1467,0,-1467
"38","1993-02",0.0260214841463,7233.36115765,4141.87346415683,1276,0,-1276
"39","1993-03",0.0259745371076374,8051.21969297056,5177.58444537098,924,0,-924
"40","1993-04",0.0259613506984797,5733.82864037677,3440.82529349203,546,0,-546
"41","1993-05",0.0259834177751576,5047.48183781757,1592.15538714994,181,11,-170
"42","1993-06",0.0260398941165253,6413.13255521626,1008.10313586061,54,141,87
"43","1993-07",0.0261313064068766,8787.90297558258,754.177542997026,0,257,257
"44","1993-08",0.0262568328611743,8514.83756947226,672.923291016699,9,269,260
"45","1993-09",0.0264186277725675,7466.91235998281,819.333602654542,176,17,-159
"46","1993-10",0.026616170069429,5227.5605773796,1344.44027357592,450,13,-437
"47","1993-11",0.0268516841521354,5803.30051399504,2916.44378865045,944,0,-944
"48","1993-12",0.0271236402770345,7776.1517212244,4585.47782731732,1083,0,-1083
"49","1994-01",0.0274311945624074,10156.6514998797,5682.69116057453,1402,0,-1402
"50","1994-02",0.027705332798021,8159.63672892773,5752.97730584042,1254,0,-1254
"51","1994-03",0.0279410501482995,6960.38475865125,4095.8051914929,731,0,-731
"52","1994-04",0.0281361923828679,5294.82667574194,2698.59051762018,470,17,-453
"53","1994-05",0.028297518132755,4998.32262818775,1562.00348049563,128,89,-39
"54","1994-06",0.0284201272697413,6508.92554014908,790.594460283167,9,254,245
"55","1994-07",0.0285056115327513,8654.51681231224,679.509611372592,2,215,213
"56","1994-08",0.028554136918727,7810.38909344778,626.131241614669,3,225,222
"57","1994-09",0.0285659184588927,6517.30485491434,693.919844759974,90,124,34
"58","1994-10",0.028542271883963,5040.80056687422,1018.37272174547,336,3,-333
"59","1994-11",0.0284845840048961,5348.66956040441,2117.50697437345,761,0,-761
"60","1994-12",0.0283918260319146,7167.45150820577,4057.12912917772,1143,0,-1143
"61","1995-01",0.0282635543123586,8673.67821879667,5435.4900623747,1286,0,-1286
"62","1995-02",0.0281750713139991,8522.38162023364,4771.72715965337,897,0,-897
"63","1995-03",0.0281255314841942,7072.66107297413,4015.60887513209,836,0,-836
"64","1995-04",0.0281118561789252,5449.23138653784,2852.64952352033,572,0,-572
"65","1995-05",0.0281381296710861,5318.9117596246,1974.31824324823,305,0,-305
"66","1995-06",0.0282007042302101,6534.63215663935,1055.22764057752,41,176,135
"67","1995-07",0.0283005311458844,8359.81607621793,687.645033011988,5,357,352
"68","1995-08",0.0284385926556682,9579.88815013923,601.46248828576,2,392,390
"69","1995-09",0.0286132865922986,7262.27898559382,697.13702376616,152,84,-68
"70","1995-10",0.0288263867507564,5313.94572929344,1045.17608209437,405,7,-398
"71","1995-11",0.0290811223484493,6386.65410158866,2736.63669994356,890,0,-890
"72","1995-12",0.0293763591002677,8508.10675708774,4095.86708919917,1157,0,-1157
"73","1996-01",0.0297112028530158,10658.3043642133,5441.88518696797,1444,0,-1444
"74","1996-02",0.0299774655325028,9365.7954440691,5823.2254364314,1033,0,-1033
"75","1996-03",0.0301738637796837,7610.15051625065,4367.52941400205,1036,0,-1036
"76","1996-04",0.0302998786610856,6420.72237439021,3160.95242551107,494,2,-492
"77","1996-05",0.0303582571499539,5672.48874126798,1749.92193264173,255,44,-211
"78","1996-06",0.0303469156653488,7113.83287549738,973.086885713878,22,220,198
"79","1996-07",0.0302673170240056,9163.87656219393,649.46048054606,2,236,234
"80","1996-08",0.0301177881193341,8393.5672499042,614.143443199968,0,204,204
"81","1996-09",0.0299006612263916,6632.98256017889,669.768246005371,160,70,-90
"82","1996-10",0.0296170759151112,5163.73649242221,1430.34416735681,378,8,-370
"83","1996-11",0.0292662206355687,6163.61469049284,2659.96859808286,1026,0,-1026
"84","1996-12",0.0288520155060908,8532.20075844368,4790.13568357543,1341,0,-1341
"85","1997-01",0.0283713520238483,9417.27009383883,6370.35731723471,1390,0,-1390
"86","1997-02",0.0280875369738061,8250.90521957122,5144.1662035191,1004,0,-1004
"87","1997-03",0.0279986284623169,6324.07649651953,4093.84140102658,750,0,-750
"88","1997-04",0.0281033817324195,5594.34073625124,2859.87792052658,620,0,-620
"89","1997-05",0.0284040266749336,5589.54074930473,2085.87006162641,265,12,-253
"90","1997-06",0.0288984343580524,6113.01865315641,903.328986867896,2,209,207
"91","1997-07",0.0295870307230065,9404.66102772238,666.036923561437,4,342,338
"92","1997-08",0.0304673366657227,8830.75466871164,615.823287551425,10,230,220
"93","1997-09",0.0315426254472639,7747.56228843036,613.524014886239,70,115,45
"94","1997-10",0.0328133247417759,5667.53406915927,905.409560681905,413,53,-360
"95","1997-11",0.0342803204478861,6387.27843901024,2880.72354458095,894,0,-894
"96","1997-12",0.035943698402508,8955.47722435292,3788.27495421802,1102,0,-1102
"97","1998-01",0.0377999761211532,9495.15527348257,5188.42022083344,1219,0,-1219
"98","1998-02",0.0394720736119413,7943.14948192536,4361.12225974317,823,0,-823
"99","1998-03",0.0409569890298594,7317.45330420095,4255.39885590892,1036,0,-1036
"100","1998-04",0.0422491273455947,6208.0795689794,2838.07432197529,473,0,-473
"101","1998-05",0.0433537467910041,5579.10583149451,1287.16749066837,88,91,3
"102","1998-06",0.0442702489686595,8186.89121774641,786.169554199402,74,168,94
"103","1998-07",0.0449990886234612,10575.2122270108,661.292278439224,0,361,361
"104","1998-08",0.0455387849738531,9309.19842643814,673.788667846526,0,304,304
"105","1998-09",0.0458931155657015,9009.21007616177,577.751152320013,26,201,175
"106","1998-10",0.0460619020091441,6181.9491184955,1062.28261064154,330,6,-324
"107","1998-11",0.0460462926550716,5818.60951008557,2217.22517644379,692,0,-692
"108","1998-12",0.0458473277094438,7345.45848420535,2771.63986034225,1077,0,-1077
"109","1999-01",0.0454595891469457,10247.4850344952,5653.31211355894,1272,0,-1272
"110","1999-02",0.0451213731481585,6982.4187640244,3930.05648470377,802,0,-802
"111","1999-03",0.0448249941055123,8524.81322447742,3774.21807114108,809,0,-809
"112","1999-04",0.0445656570240391,6395.37922123322,2459.09532751315,461,0,-461
"113","1999-05",0.0443479741974653,5968.30148323459,1546.93458526254,150,20,-130
"114","1999-06",0.0441713237215141,7271.63743410519,776.078458920511,37,147,110
"115","1999-07",0.044036812836233,9809.01960542793,658.491992458343,1,411,410
"116","1999-08",0.0439438312012075,11075.394669201,730.123617208216,1,232,231
"117","1999-09",0.0438943046490088,8132.36877988029,519.582555689464,140,67,-73
"118","1999-10",0.0438878717037635,5779.33229424041,1379.90770531659,386,0,-386
"119","1999-11",0.0439272689375516,6208.12721043032,1766.69608379845,572,0,-572
"120","1999-12",0.0440109418228804,7942.07622223344,3309.3230497338,1025,0,-1025
"121","2000-01",0.0441340291783631,9970.98379915786,4732.83582522975,1147,0,-1147
"122","2000-02",0.0442579739486584,9948.55028740233,4401.79212727047,862,0,-862
"123","2000-03",0.0443768137497795,6518.97150841056,3708.37235478322,681,0,-681
"124","2000-04",0.0444861291455426,6031.27795990716,2900.87806656141,438,0,-438
"125","2000-05",0.0445960664645569,6763.11312793392,930.997791052321,92,81,-11
"126","2000-06",0.0446991075327753,8761.10168387683,635.33972508949,25,178,153
"127","2000-07",0.0447944838307415,10039.235455016,579.947706714332,0,323,323
"128","2000-08",0.0448875777514478,9498.89281727355,499.044432675746,0,384,384
"129","2000-09",0.0449754217462088,8131.18498543317,672.83674394062,110,155,45
"130","2000-10",0.0450601680137532,6366.5868143839,1203.75575830771,314,8,-306
"131","2000-11",0.0451441551253162,6170.40261932243,2322.9493414388,1050,0,-1050
"132","2000-12",0.0452243878849418,9602.02588531095,4445.5947171935,1512,0,-1512
"133","2001-01",0.0453047916433602,11623.4405610036,6398.38169573523,1215,0,-1215
"134","2001-02",0.0453791084287469,8661.50542236193,4921.41991599617,1238,0,-1238
"135","2001-03",0.0454444069723948,7406.49183217534,4110.94872706921,942,0,-942
"136","2001-04",0.0454999314678197,7003.94525452693,2982.0112515747,389,19,-370
"137","2001-05",0.0455482036846391,6298.66454184413,1640.53218044852,148,66,-82
"138","2001-06",0.0455859544990867,7740.308924836,765.31069646904,43,198,155
"139","2001-07",0.0456160559120911,9543.08546898509,621.635842083162,0,402,402
"140","2001-08",0.0456366715623776,9822.51574975822,589.27944293175,0,310,310
"141","2001-09",0.0456479269937553,8971.66644352717,570.136310486587,96,75,-21
"142","2001-10",0.0456602202834431,6302.19416405739,1124.23687762081,399,6,-393
"143","2001-11",0.0456605816314863,6446.61574944183,3029.86908670931,543,0,-543
"144","2001-12",0.0456549187137535,6990.52447421973,2750.93831635794,1044,0,-1044
"145","2002-01",0.0456435363383984,10524.6982774339,5584.80913296266,1090,0,-1090
"146","2002-02",0.0456577471229645,8376.16932983636,4017.79312449529,979,0,-979
"147","2002-03",0.0457001786437826,7819.72356238789,4011.52895989253,1066,0,-1066
"148","2002-04",0.0457651934864769,6700.44421866365,2716.93266547474,429,18,-411
"149","2002-05",0.0458538577292286,7011.65956609896,1189.0819112308,256,35,-221
"150","2002-06",0.045965697923494,8478.24249464079,743.536458241461,4,326,322
"151","2002-07",0.046104246026358,10688.8099689318,573.728869468492,0,448,448
"152","2002-08",0.0462666047709967,11184.8129934678,473.331208322927,4,294,290
"153","2002-09",0.0464526902365485,9487.55998528456,563.643997075013,88,128,40
"154","2002-10",0.0466653652398013,7418.89285442577,1083.30186563807,593,6,-587
"155","2002-11",0.0469055314560921,6776.2044682101,2695.97014977337,839,0,-839
"156","2002-12",0.0471756080989166,9571.38888654451,3971.49741910403,1036,0,-1036
"157","2003-01",0.0474710411158903,10730.2796011233,4957.92697427502,1256,0,-1256
"158","2003-02",0.0477496000170365,10865.3933935311,4611.64850806904,1133,0,-1133
"159","2003-03",0.0480049963092527,8237.4510552207,4173.32132279878,803,0,-803
"160","2003-04",0.0482343487541361,6082.65341433073,2120.12110952677,400,17,-383
"161","2003-05",0.0484379538814214,6622.75411642222,1093.69234993335,215,21,-194
"162","2003-06",0.0486037190213757,7567.14944335423,674.815962070383,44,139,95
"163","2003-07",0.0487423722830861,10544.9528383261,551.576892891763,0,377,377
"164","2003-08",0.0488575132301681,10361.3494012129,565.676745742541,1,358,357
"165","2003-09",0.0489509391945164,9294.91545283961,494.011623251265,144,49,-95
"166","2003-10",0.0490210235887115,6376.25082408882,1026.33973098025,315,10,-305
"167","2003-11",0.0490691178878987,6003.70142061442,2209.39961188041,873,0,-873
"168","2003-12",0.0490982918358818,9791.67716449894,3978.31801727933,1066,0,-1066
"169","2004-01",0.0491054958102417,11353.3159419511,5076.13090190309,1341,0,-1341
"170","2004-02",0.0491277190764902,10555.4036959116,4931.78014425973,1181,0,-1181
"171","2004-03",0.0491608192682482,8438.34923902695,3457.12113878429,669,0,-669
"172","2004-04",0.049199594246042,6983.05114242295,1717.55424716057,391,7,-384
"173","2004-05",0.0492475118774778,7213.48732042324,1056.26867429375,158,73,-85
"174","2004-06",0.0493097735210533,9821.16255716854,655.830344385097,43,114,71
"175","2004-07",0.0493823167679622,11047.0089188935,566.333443672871,13,239,226
"176","2004-08",0.0494643006196267,10190.380350958,532.374765872812,30,169,139
"177","2004-09",0.049558137026144,8655.25904386282,498.448045650301,41,148,107
"178","2004-10",0.0496621085530864,6813.82994223306,835.047659246237,354,2,-352
"179","2004-11",0.0497824060169782,6344.09149315111,1536.71280278515,739,0,-739
"180","2004-12",0.0499162516560523,9463.36661960082,3228.79442744011,1088,0,-1088
"181","2005-01",0.0500616203360773,10948.8980408522,5192.25115868336,1365,0,-1365
"182","2005-02",0.0502105913901865,9678.89932681521,4187.40432986435,882,0,-882
"183","2005-03",0.0503511600010199,9190.1260254228,3200.96655156655,796,0,-796
"184","2005-04",0.050480915789704,6893.30886909499,1877.7038819955,391,3,-388
"185","2005-05",0.0506032239381484,6575.93508871391,1208.74883185244,201,53,-148
"186","2005-06",0.050722712276878,8754.00142948285,614.338802620888,8,236,228
"187","2005-07",0.0508346234362592,11580.1528847073,514.79474432051,5,375,370
"188","2005-08",0.0509416591373509,11885.761879251,479.826191076216,1,266,265
"189","2005-09",0.0510422824425155,10606.1232807631,509.941495699953,46,166,120
"190","2005-10",0.0511384546522115,7762.65005125772,707.247378936546,387,32,-355
"191","2005-11",0.0512376297160315,6844.88681874363,1448.6921224136,712,0,-712
"192","2005-12",0.0513269755046902,10405.6452606174,3625.14903739612,1265,0,-1265
"193","2006-01",0.0514146328980181,10441.8033568795,3871.3148261284,874,0,-874
"194","2006-02",0.0515023699313496,8670.78865069102,3292.91800197238,1009,0,-1009
"195","2006-03",0.0515946300060528,8476.79338898369,3678.90878860214,855,0,-855
"196","2006-04",0.0516848434580887,7043.19336845389,2169.09212462298,323,9,-314
"197","2006-05",0.0517768856805887,6898.30183117633,1072.4303852711,155,87,-68
"198","2006-06",0.0518660648026649,9475.79412023317,640.345026334717,3,238,235
"199","2006-07",0.0519544695726132,11533.4939869303,502.412700885521,0,394,394
"200","2006-08",0.0520452746584591,12317.139063626,474.433198882574,2,250,248
"201","2006-09",0.0521334642103891,9713.34684845031,514.276979089167,155,26,-129
"202","2006-10",0.0522260534169963,6979.99414530133,883.258461581007,510,22,-488
"203","2006-11",0.0523217046917775,7317.56235425204,1929.70531137811,783,0,-783
"204","2006-12",0.0524148136635914,9210.93388528365,3138.93280012573,1023,0,-1023
"205","2007-01",0.0525129011807906,10273.4911254792,4025.40668582402,1312,0,-1312
"206","2007-02",0.0526023439027056,10972.8079233167,4901.57245659614,1189,0,-1189
"207","2007-03",0.0526812015435687,8796.71458876027,3996.23363745034,602,0,-602
"208","2007-04",0.0527438355924045,6996.45082415758,1980.65229410015,520,9,-511
"209","2007-05",0.0527951478084615,7474.50722688359,1186.27478312378,76,53,-23
"210","2007-06",0.0528311830667592,9599.37293559512,602.046070397639,14,186,172
"211","2007-07",0.0528520245494202,11211.6243131389,498.541300739718,0,354,354
"212","2007-08",0.0528599198631791,12698.1226835422,490.249887908913,0,353,353
"213","2007-09",0.0528553611469007,11294.4280139218,464.78656625656,83,102,19
"214","2007-10",0.0528410888491367,7992.4851468558,676.515018510384,331,19,-312
"215","2007-11",0.0528138643499276,7466.38869612259,1439.68864991383,764,0,-764
"216","2007-12",0.0527765430611653,9324.19257343202,3452.12489487603,1326,0,-1326
"217","2008-01",0.0527305496443999,11499.3788786811,4689.70353041077,1368,0,-1368
"218","2008-02",0.0526873120229791,10063.1049797684,4917.48670411505,1183,0,-1183
"219","2008-03",0.052644714215772,8246.60649787572,4010.59966674175,853,0,-853
"220","2008-04",0.0526065471688078,7154.62189564931,2634.18968671211,578,0,-578
"221","2008-05",0.0525649018805483,7035.50456423429,1429.27480835863,230,16,-214
"222","2008-06",0.0525254500148668,10207.1485934253,686.824270204066,5,152,147
"223","2008-07",0.0524853198394084,11869.4370928449,503.568334231454,0,320,320
"224","2008-08",0.0524445430642747,11519.1141032816,505.732142374281,0,210,210
"225","2008-09",0.0524062495319204,9556.94774665616,540.802174715867,101,49,-52
"226","2008-10",0.0523710900529306,7213.11188313015,714.053605315166,421,3,-418
"227","2008-11",0.0523386729511124,7556.32407738979,1597.92359194764,792,0,-792
"228","2008-12",0.0523117483040063,10713.671603015,3622.55969596489,1367,0,-1367
"229","2009-01",0.0522842785369765,11761.2447203599,4820.68859757613,1279,0,-1279
"230","2009-02",0.0522691015704072,10440.3027315832,4306.30162116964,970,0,-970
"231","2009-03",0.0522614240936814,9340.49912598633,3631.84261162393,858,0,-858
"232","2009-04",0.0522643586523568,7214.37050504762,2480.62040387567,533,3,-530
"233","2009-05",0.0522739052856881,7280.40740454366,1145.77001903146,167,47,-120
"234","2009-06",0.0522909495452818,9572.01743733782,622.242950491834,45,162,117
"235","2009-07",0.052315280112389,12001.7143039629,503.449833122262,5,181,176
"236","2009-08",0.0523476009340981,11450.3054395322,482.175216020245,18,172,154
"237","2009-09",0.0523851927410009,9346.77785406888,491.623585339571,97,26,-71
"238","2009-10",0.0524325997470253,7278.9200632461,959.796293263415,654,0,-654
"239","2009-11",0.0524897546182332,6847.36403275017,1688.11113985989,646,0,-646
"240","2009-12",0.0525605355154839,10321.6328897775,3181.1730100423,1440,0,-1440
"241","2010-01",0.0526369151777966,14142.3028465948,4711.00931005851,1435,0,-1435
"242","2010-02",0.0527317669830404,11171.5359632402,4090.03048525722,1211,0,-1211
"243","2010-03",0.0528456702078755,10202.159306683,3810.89482202847,776,0,-776
"244","2010-04",0.0529762671555116,6832.35797720673,1879.17006493111,331,2,-329
"245","2010-05",0.0531239660648592,7196.29002922736,881.476974707843,249,60,-189
"246","2010-06",0.0532891927964548,10592.8280549288,617.986500464832,4,208,204
"247","2010-07",0.0534687876143873,13088.6765423037,439.398792777129,0,333,333
"248","2010-08",0.0536631352821701,12522.2400997798,417.636940877233,0,344,344
"249","2010-09",0.0538725828581465,10537.740809884,379.398907836414,70,69,-1
"250","2010-10",0.0540990937591899,7281.63812496521,624.603744696786,315,4,-311
"251","2010-11",0.0543479680863252,6902.04779105811,2195.25083528456,803,0,-803
"252","2010-12",0.0546153395026664,11848.0028782354,3832.10526235371,1234,0,-1234
"253","2011-01",0.054897809563993,14033.0438432743,5022.09403340599,1439,0,-1439
"254","2011-02",0.055147437828956,9472.60234769841,4024.15110335101,1099,0,-1099
"255","2011-03",0.0553616186868941,7923.05668865163,3548.10596840043,848,0,-848
"256","2011-04",0.0555330728883728,6945.58362861576,1609.40102465812,480,1,-479
"257","2011-05",0.0556672942685939,7141.55864132312,977.543351201088,226,47,-179
"258","2011-06",0.0557648254018698,11040.4343715375,629.447956608632,11,176,165
"259","2011-07",0.0558196878554223,12488.8103091456,521.152687592212,0,428,428
"260","2011-08",0.0558367274976303,12256.6551139644,401.133945530986,0,270,270
"261","2011-09",0.055812885623252,9254.14576232125,459.245132836698,175,46,-129
"262","2011-10",0.0557547172899413,6609.05012725399,810.686629286584,358,18,-340
"263","2011-11",0.0556620342766216,7305.311738231,1983.63588851853,778,0,-778
"264","2011-12",0.0555318673025576,9027.34648171487,3456.18054465678,1110,0,-1110
"265","2012-01",0.0553635794345148,10737.019374931,3587.02557463733,1052,0,-1052
"266","2012-02",0.0552311724466171,8554.69245804624,3298.08554558615,1023,0,-1023
"267","2012-03",0.0551231871809196,7634.2551688612,1882.50810541004,380,9,-371
"268","2012-04",0.0550451217786718,6036.05920729212,866.129560292937,319,12,-307
"269","2012-05",0.0549967485729291,7777.04302884561,696.122682457751,88,97,9
"270","2012-06",0.0549738239523824,9225.82040161299,506.371995566432,12,285,273
"271","2012-07",0.0549782957210348,12250.5375665018,588.62806337673,0,495,495
"272","2012-08",0.055008444127832,11097.5387932573,299.088495095135,8,264,256
"273","2012-09",0.0550649225007575,8734.2666163034,386.611470832798,101,84,-17
"274","2012-10",0.0551522522248001,6591.47424272099,981.982348200447,494,0,-494
"275","2012-11",0.0552703576516482,7946.32984339806,1889.80136489248,724,0,-724
"276","2012-12",0.0554193507152883,9524.12573041813,3355.50568804322,1143,0,-1143
"277","2013-01",0.0555984656724884,11019.0726126914,4294.10877264,1234,0,-1234
"278","2013-02",0.0557688103850719,9371.21419127274,3484.48897127341,1009,0,-1009
"279","2013-03",0.0559229459304426,9719.72839916806,3315.04168498291,942,0,-942
"280","2013-04",0.0560603766744826,7273.47351264931,2111.6096081599,617,1,-616
"281","2013-05",0.0561863872740946,6574.42810675441,1074.25823174179,215,56,-159
"282","2013-06",0.0562910543421751,9115.86470491236,571.742724613592,31,193,162
"283","2013-07",0.0563834600523754,10839.6947199984,541.156050186728,9,293,284
"284","2013-08",0.0564590328204933,10489.5968903608,317.509162410091,0,292,292
"285","2013-09",0.0565176777018048,8897.8018106295,407.941230562373,33,157,124
"286","2013-10",0.056563527566573,6780.77615524964,968.629806912502,447,12,-435
"287","2013-11",0.0565960229361962,7531.97315026218,2427.45310913751,842,0,-842
"288","2013-12",0.0566201074431851,10831.9633102824,4484.86955930364,1315,0,-1315
"289","2014-01",0.056629246577471,13011.5747662566,4825.74434682494,1283,0,-1283
"290","2014-02",0.0566530376246736,10775.0719739777,4409.41275803548,1216,0,-1216
"291","2014-03",0.0566898600709961,9583.92204235653,3235.83092689241,912,0,-912
"292","2014-04",0.0567367584664045,6822.79106019822,1712.21998637131,466,0,-466
"293","2014-05",0.0567927878708565,7353.88616785711,990.651546281972,192,80,-112
"294","2014-06",0.0568595255728808,9444.23069058928,542.142769133053,16,180,164
"295","2014-07",0.0569371854377215,11032.2595995391,456.914227455163,9,210,201
"296","2014-08",0.0570204880624897,10015.3612323516,421.394104383908,0,239,239
"297","2014-09",0.0571157451837374,9210.51920829219,467.845240470059,112,67,-45
"298","2014-10",0.0572229407533019,6723.79055049123,834.207378958813,344,2,-342
"299","2014-11",0.0573435437527091,7615.32998821247,2675.72481134821,965,0,-965
"300","2014-12",0.05747910971755,10680.3105990765,3793.25480643845,1106,0,-1106
"301","2015-01",0.0576270675624825,11841.1151006933,4152.28849403644,1169,0,-1169
"302","2015-02",0.0577633965376794,11081.9167640259,4010.82049611753,1165,0,-1165
"303","2015-03",0.0578798581634581,9966.56540003252,2426.34145121648,689,1,-688
"304","2015-04",0.0579765176025406,6157.00126953329,1228.36973029195,399,0,-399
"305","2015-05",0.0580546213005144,7207.13808380326,771.560481593021,209,18,-191
"306","2015-06",0.0581145329816457,10090.3829174316,557.535248199596,5,191,186
"307","2015-07",0.0581544220146454,12055.7995191074,464.233703936175,4,299,295
"308","2015-08",0.0581744761773998,10731.3960685234,398.552125441111,13,205,192
"309","2015-09",0.0581769901269827,9047.2085061977,391.405789571353,31,167,136
"310","2015-10",0.0581610139998692,6739.3184595813,619.049168955607,308,10,-298
"311","2015-11",0.0581330436449334,6390.44565830412,1671.70201348169,672,0,-672
"312","2015-12",0.0580855177191139,8793.71917905555,3214.17645344645,1030,0,-1030
"313","2016-01",0.0580280219487817,11436.8396923882,4042.32676591774,1235,0,-1235
"314","2016-02",0.0579796325699601,9952.89199218964,3122.0615768167,890,0,-890
"315","2016-03",0.0579379485420572,7932.08731634175,1998.34267306222,620,0,-620
"316","2016-04",0.057903397459332,6170.96006014763,1326.11270945461,397,1,-396
"317","2016-05",0.0578759895613933,7017.66887559855,781.836805254735,188,28,-160
"318","2016-06",0.0578563721493914,10036.672005514,515.772860227069,1,312,311
"319","2016-07",0.0578420614736384,12063.5710667658,406.077622282813,4,314,310
"320","2016-08",0.057835554704345,11949.1258435461,378.484434382169,1,246,245
"321","2016-09",0.0578368503924956,9948.20361216839,401.545969841451,35,126,91
"322","2016-10",0.0578449572086917,6808.39363616217,585.980889305557,232,6,-226
"323","2016-11",0.0578655720521819,7122.15869779236,1348.44313085052,599,0,-599
"324","2016-12",0.0578965395166705,9884.89627502049,3930.54652979041,1225,0,-1225
"325","2017-01",0.0579340240072698,10081.4719558643,4290.64024757295,1199,0,-1199
"326","2017-02",0.0579738167699395,7453.50945543476,2654.37469747138,789,0,-789
"327","2017-03",0.058007972616295,8048.76178244858,2355.58350038008,713,0,-713
"328","2017-04",0.0580373227908894,6287.68433402225,1263.95570201752,428,2,-426
"329","2017-05",0.0580601954302127,7555.16069464234,856.230617119311,196,32,-164
"330","2017-06",0.0580780456648685,9415.71002175535,485.103766875991,5,241,236
"331","2017-07",0.0580890831039978,11522.0502983587,380.783818721164,0,375,375
"332","2017-08",0.0580944422903124,10755.2531168505,245.451620176887,4,147,143
"333","2017-09",0.0580956400540331,8528.22135037987,349.940342341419,66,131,65
"334","2017-10",0.058092773528038,6980.14504638546,793.43758403173,379,6,-373
"335","2017-11",0.0580888891966752,7564.83968362585,2244.62792159189,733,0,-733
"336","2017-12",0.0580831899264332,10059.8516961026,3370.49600177046,1167,0,-1167
