"","Date","Real GDP per capita (millions of chained 2012 dollars per person)","Electricity Sale to Residential Consumers per capita (MJ/person)","Natural Gas Deliveries to Residential Consumers per capita (MJ/person)","HDD","CDD","DD"
"1","1990-01",0.0310517420529581,1136.5524019957,2749.33203115906,816,0,-816
"2","1990-02",0.0309446526231749,990.121081894189,2759.82781864072,698,0,-698
"3","1990-03",0.0308302778302641,861.448270489784,2016.71671564416,390,3,-387
"4","1990-04",0.0306534979277611,765.800543978723,1023.24616948872,141,35,-106
"5","1990-05",0.0305042783850394,615.025375910739,778.612309095938,105,112,7
"6","1990-06",0.030346669466595,535.346291485942,696.165295555486,27,359,332
"7","1990-07",0.0301942204351968,559.921336097704,502.082989668963,0,550,550
"8","1990-08",0.0300385404332096,562.909854872886,461.936913430329,10,447,437
"9","1990-09",0.0298856160727539,592.648572691649,460.208880751652,21,290,269
"10","1990-10",0.0297414072158282,551.93771087202,629.882836440514,169,40,-129
"11","1990-11",0.0296399326538125,695.319303349465,1111.10123339676,536,0,-536
"12","1990-12",0.0295481056774418,881.716550627114,2259.78986139118,1026,0,-1026
"13","1991-01",0.0294726548664293,1199.17250707691,3403.7942166624,854,0,-854
"14","1991-02",0.0294012298299366,957.489153865238,2173.38638913788,469,0,-469
"15","1991-03",0.0293609001366803,823.441043313731,1824.61440184908,615,0,-615
"16","1991-04",0.0293196561931747,681.322209526645,1611.25672427248,311,4,-307
"17","1991-05",0.0292692768937782,600.295343008762,1032.50826714608,183,63,-120
"18","1991-06",0.029208428043034,513.978830850839,724.887004253491,38,247,209
"19","1991-07",0.0292219980214089,526.692189084778,526.588640445303,0,523,523
"20","1991-08",0.0292425357208755,552.205801431732,460.362184864456,1,462,461
"21","1991-09",0.0292799702068203,590.36707622284,459.342694973684,22,280,258
"22","1991-10",0.0293466920214597,529.334527316366,568.988767235428,195,133,-62
"23","1991-11",0.0294509917188959,794.56784494842,1097.21578084067,535,0,-535
"24","1991-12",0.0295986463841655,921.101496054641,2449.30209735713,819,0,-819
"25","1992-01",0.0297688893572829,963.056894426344,2930.82159365008,852,0,-852
"26","1992-02",0.0299409500026108,894.358988224093,2167.69377700445,515,0,-515
"27","1992-03",0.0300984020042789,771.371898987123,1735.2733941054,423,0,-423
"28","1992-04",0.0302309635496612,714.854301487341,1152.2537165514,115,57,-58
"29","1992-05",0.0303570538074188,583.400774226862,661.997233781089,26,195,169
"30","1992-06",0.0304712532108165,501.030221864704,571.300703510122,22,315,293
"31","1992-07",0.0305805155695462,482.809864302377,549.952886690539,3,463,460
"32","1992-08",0.0306672021329315,486.717114002324,432.031456716384,8,521,513
"33","1992-09",0.0307604155969901,516.804902348221,494.955949062986,27,297,270
"34","1992-10",0.030853071259843,597.851544338275,589.991415232641,127,81,-46
"35","1992-11",0.0309564419569051,745.01562203756,992.321590295487,603,0,-603
"36","1992-12",0.0310689295463623,918.131158068858,2666.65838674028,891,0,-891
"37","1993-01",0.0311765636982909,1155.06329949335,3135.9733317204,876,0,-876
"38","1993-02",0.0313040571282917,901.260444666999,2538.51470413606,659,0,-659
"39","1993-03",0.0314382912706659,841.538562886133,2178.18939035091,363,1,-362
"40","1993-04",0.0315620696758924,695.458031944924,1202.22668781924,221,19,-202
"41","1993-05",0.0316870633653543,520.611661951518,866.572106959597,63,164,101
"42","1993-06",0.0318068969831454,499.281093956982,722.648419923051,58,287,229
"43","1993-07",0.0319258951276197,473.422778618243,474.431650212616,7,423,416
"44","1993-08",0.0320380151758611,539.39081495718,481.569535953367,8,447,439
"45","1993-09",0.0321601238507156,521.497413842354,509.74746422094,44,246,202
"46","1993-10",0.0322883717342743,580.876305005769,626.366901413411,178,53,-125
"47","1993-11",0.0324395840330473,748.671065218079,1156.91369230984,636,0,-636
"48","1993-12",0.0326019972059155,903.1287642348,2516.786476189,795,0,-795
"49","1994-01",0.032769237100883,1122.76253804026,2762.62010286325,738,0,-738
"50","1994-02",0.0329371785630069,997.719724605262,2548.04560360182,675,0,-675
"51","1994-03",0.0330692235020344,778.235131266016,1907.95777074313,336,1,-335
"52","1994-04",0.0331503962991999,620.895847103671,1117.02936777033,232,52,-180
"53","1994-05",0.0332295156335665,512.103637694609,868.484234148798,86,139,53
"54","1994-06",0.0332715008631549,483.29436247082,663.156576602869,17,439,422
"55","1994-07",0.0332877572330604,493.973561551147,500.085577409659,0,603,603
"56","1994-08",0.0332793675681549,513.59322700173,436.739838249343,0,564,564
"57","1994-09",0.0332476630312215,495.930225586303,468.042003588649,24,284,260
"58","1994-10",0.0332014913627266,531.389642213927,611.270217391865,226,23,-203
"59","1994-11",0.0331500109832861,646.09127560966,1286.23442493483,740,0,-740
"60","1994-12",0.0330856758448952,839.591594067526,2821.99667613487,795,0,-795
"61","1995-01",0.0330050214686653,948.084540657858,2865.40499837696,728,0,-728
"62","1995-02",0.0329723614984138,864.221798972083,2256.50921008179,399,0,-399
"63","1995-03",0.0329820569162479,751.970963886497,1587.52123698381,484,0,-484
"64","1995-04",0.0330131170403732,651.636684026633,1557.8950938168,300,12,-288
"65","1995-05",0.0330937807691003,531.009452341964,1129.18684728121,149,63,-86
"66","1995-06",0.0331991686222136,525.817047280466,779.782537188784,60,261,201
"67","1995-07",0.0333359998453148,515.209932778698,572.255843208165,2,493,491
"68","1995-08",0.0335111434331813,546.741967377948,466.01421560012,1,511,510
"69","1995-09",0.0337138450949732,506.040607276653,479.513868478426,25,321,296
"70","1995-10",0.0339563025746278,536.021712388495,576.114941978694,170,47,-123
"71","1995-11",0.0342603159037359,720.84412510053,947.711569012868,351,0,-351
"72","1995-12",0.0346181067555617,892.880048219369,1650.45429324548,699,0,-699
"73","1996-01",0.035023588431006,1004.23655676255,2613.87646211138,731,0,-731
"74","1996-02",0.0353334928370366,923.78784089133,2271.85133383115,522,0,-522
"75","1996-03",0.0355392360738682,808.226682550465,2013.80809134494,419,0,-419
"76","1996-04",0.0356375447285003,662.481824024199,1301.98281336596,213,42,-171
"77","1996-05",0.0356469010964711,543.026971412021,870.26380255869,96,189,93
"78","1996-06",0.0355538199533188,498.020309626621,693.239997604557,19,384,365
"79","1996-07",0.0353683645905492,497.652634460813,531.932545266847,0,625,625
"80","1996-08",0.0350801543873286,507.673279302161,460.8403942915,2,540,538
"81","1996-09",0.0347049742534193,489.805115372928,495.252313162574,50,243,193
"82","1996-10",0.0342506530992335,526.35689345486,602.176905994081,277,89,-188
"83","1996-11",0.0337125328306319,752.441495233637,1387.46811362727,483,0,-483
"84","1996-12",0.033115910128667,917.647027380002,2262.28525301508,728,0,-728
"85","1997-01",0.0324416047364147,1016.49774417534,2989.33781025964,746,0,-746
"86","1997-02",0.0320655552056743,829.741871527627,2549.98736632213,581,0,-581
"87","1997-03",0.0319734475257305,729.204320989042,2107.207656591,334,4,-330
"88","1997-04",0.0321554799288032,607.615047935465,1334.94597480289,288,45,-243
"89","1997-05",0.0326233538391153,458.543194545473,919.10179687074,41,268,227
"90","1997-06",0.0333618458640378,447.270000732576,643.504633414908,24,338,314
"91","1997-07",0.0343715704754646,523.19737018557,579.585960796273,3,467,464
"92","1997-08",0.035635146047254,498.081433840243,505.57826680116,0,519,519
"93","1997-09",0.0371709914934893,447.768690938151,518.66651876457,29,288,259
"94","1997-10",0.0389800700649292,481.502463958364,656.828432250689,230,50,-180
"95","1997-11",0.0410664139616909,654.360801452042,1229.74287145304,460,0,-460
"96","1997-12",0.0434292313945402,704.906169998158,2472.10309966011,844,0,-844
"97","1998-01",0.0460451471395832,839.503011004915,3186.25391994616,695,0,-695
"98","1998-02",0.0484273491918883,669.23615664846,2623.27556528611,620,0,-620
"99","1998-03",0.0505577766817379,650.031048453386,2402.34659481688,473,3,-470
"100","1998-04",0.0524013948297876,518.180471359557,1777.30578380679,345,14,-331
"101","1998-05",0.0539928608044084,424.585623045314,1181.82837816653,158,47,-111
"102","1998-06",0.0553294449453459,397.359872582306,930.54805597995,37,229,192
"103","1998-07",0.0564153128091502,501.91372134266,610.042577863414,0,570,570
"104","1998-08",0.057242290147009,507.963399506939,506.521100215234,0,566,566
"105","1998-09",0.0578362859584514,458.977153592198,512.461164764364,33,274,241
"106","1998-10",0.0581978795603784,505.75601975626,848.99048325898,231,15,-216
"107","1998-11",0.0583364283139957,585.845823217403,1567.47497015684,516,0,-516
"108","1998-12",0.0582608715198941,700.773734440372,2689.56422852036,806,0,-806
"109","1999-01",0.0579385225435451,893.577580404327,3061.63447133158,686,0,-686
"110","1999-02",0.0576538778555297,688.259695501668,2672.1507342872,551,0,-551
"111","1999-03",0.0573550093737362,621.376071441532,2062.18443551979,393,0,-393
"112","1999-04",0.0570095106163649,505.623471770136,1668.11090969556,377,22,-355
"113","1999-05",0.0566472009623741,454.239569274433,1131.42206108789,111,148,37
"114","1999-06",0.056264776818995,397.15896548025,752.192509357264,40,344,304
"115","1999-07",0.0558709173235923,480.885639563466,569.12723357072,0,516,516
"116","1999-08",0.0554640735887158,474.579735671447,552.703370929592,4,483,479
"117","1999-09",0.0550592688795721,429.596321051502,566.278071500686,27,294,267
"118","1999-10",0.0546575234066194,489.149281146584,710.023988161478,130,100,-30
"119","1999-11",0.0542789698332067,508.532668476139,1160.91831854679,363,0,-363
"120","1999-12",0.053917705898973,647.476970755206,2523.22937262613,749,0,-749
"121","2000-01",0.0535495815198817,723.614826591575,2823.34299547557,651,0,-651
"122","2000-02",0.0532426851408218,617.746948483458,2162.65221729672,519,0,-519
"123","2000-03",0.0529596799291569,517.605289458995,2055.78628574121,411,0,-411
"124","2000-04",0.05267419677253,455.620062351991,1111.75395840054,141,72,-69
"125","2000-05",0.052440477635478,371.572553229385,852.819409821038,71,270,199
"126","2000-06",0.0522153013667637,372.692996273299,639.072414796808,9,456,447
"127","2000-07",0.0519934365569007,452.05916333748,540.832342462405,3,552,549
"128","2000-08",0.0518021634929468,473.451147847902,496.676023625833,0,550,550
"129","2000-09",0.0516243215820207,408.530481157492,575.36346011646,45,291,246
"130","2000-10",0.051469845903241,423.7331895622,738.990341202191,224,71,-153
"131","2000-11",0.0513493763283383,513.754647995604,1700.62036214508,645,0,-645
"132","2000-12",0.0512462610385673,727.688802880554,2603.37553944332,698,0,-698
"133","2001-01",0.0511793830307688,683.547474982156,2913.02287153178,817,0,-817
"134","2001-02",0.0511275282646284,674.16788787537,2848.02968634691,628,0,-628
"135","2001-03",0.051075856521202,563.857787429273,2088.52080591596,343,6,-337
"136","2001-04",0.0510206370037048,462.278075126112,1296.68485574497,279,49,-230
"137","2001-05",0.0509745299675378,398.751837781549,859.153124712561,41,318,277
"138","2001-06",0.0509212046447455,369.310787811564,613.943127452687,15,425,410
"139","2001-07",0.0508749642959252,487.427194554647,543.231915179129,0,535,535
"140","2001-08",0.0508266576718214,486.570928883919,517.876016475527,0,585,585
"141","2001-09",0.0507768941260686,407.531729995193,535.998407989313,18,354,336
"142","2001-10",0.0507765379946079,409.059776217846,643.802454425261,108,95,-13
"143","2001-11",0.0507617429485584,452.993438683684,1127.9503823118,428,1,-427
"144","2001-12",0.0507613185311046,588.484273077303,3020.12296205264,799,0,-799
"145","2002-01",0.050776534066636,652.973394909007,3007.36727569332,783,0,-783
"146","2002-02",0.0507905406837872,575.596460381654,2857.546114835,555,0,-555
"147","2002-03",0.0508162381481956,593.439199678901,1897.3395537231,508,3,-505
"148","2002-04",0.0508265195853321,481.120770549483,1221.00468953145,172,68,-104
"149","2002-05",0.0508268288797446,411.541524219924,887.245413567834,100,166,66
"150","2002-06",0.0508152008281336,398.915326943356,653.835962458757,15,413,398
"151","2002-07",0.0508087346245955,497.37549230259,519.582083478663,0,656,656
"152","2002-08",0.0507938235033643,451.210027143516,471.349610998187,4,499,495
"153","2002-09",0.0507703682446457,431.121499790898,540.346809728677,29,306,277
"154","2002-10",0.0507519768827412,454.616601388387,711.693287402277,214,39,-175
"155","2002-11",0.0507428046088897,529.429692602119,1293.83247558351,468,0,-468
"156","2002-12",0.050753796716181,614.518395004019,2095.98149006534,751,0,-751
"157","2003-01",0.0507638568297958,686.557510671596,2687.97869223162,530,0,-530
"158","2003-02",0.0508430870227511,654.669854417812,2254.84589319174,574,0,-574
"159","2003-03",0.0509623345796013,610.531312099228,2002.58229036668,395,1,-394
"160","2003-04",0.0511083159603595,454.113966433192,1385.71474572162,298,9,-289
"161","2003-05",0.0512820813717308,371.30644173158,1038.7681780886,112,221,109
"162","2003-06",0.0514293905935429,346.785451762034,597.894206615441,9,413,404
"163","2003-07",0.0515978504068564,434.972713250406,543.412180254953,0,675,675
"164","2003-08",0.0518028331352396,483.613223609556,482.993067801676,0,534,534
"165","2003-09",0.0520515870615648,408.615943834476,520.370725947635,22,344,322
"166","2003-10",0.0523362007786807,397.783930704199,613.364314941559,90,141,51
"167","2003-11",0.0526619868296189,518.285121474952,1352.74562567944,601,0,-601
"168","2003-12",0.0530419857978876,602.961827250696,2572.57671984384,746,0,-746
"169","2004-01",0.0534621279075753,709.924498104494,3230.69584807466,798,0,-798
"170","2004-02",0.0538808888539363,642.295032145848,2809.8983785019,694,0,-694
"171","2004-03",0.0542800002865828,536.649058351021,1914.2166209048,238,27,-211
"172","2004-04",0.054636096161214,423.953561346819,956.893086398315,169,25,-144
"173","2004-05",0.0549649572203581,367.834851246961,811.7682981442,69,183,114
"174","2004-06",0.0552904333087973,334.80108120314,665.994530880663,11,393,382
"175","2004-07",0.0555943642535665,387.003550307656,556.698391036568,0,577,577
"176","2004-08",0.0558731663501724,383.286834798333,504.949940604609,4,498,494
"177","2004-09",0.0561380826539059,375.38763584158,565.130185325524,42,268,226
"178","2004-10",0.0563815686659376,421.499164774849,735.148223782825,231,68,-163
"179","2004-11",0.0566320693749474,479.639847914977,1615.86760643205,569,0,-569
"180","2004-12",0.0568771790819603,606.068201477745,2799.15247187972,1019,0,-1019
"181","2005-01",0.0571079174557681,706.043754410553,3140.66483991854,745,0,-745
"182","2005-02",0.0573606164233841,582.303814144881,2583.46014517746,609,0,-609
"183","2005-03",0.0575807169888941,526.917558588469,1782.70266999019,458,0,-458
"184","2005-04",0.0577573386721302,416.109720107642,1406.76379132397,304,1,-303
"185","2005-05",0.0579058655786665,358.82812924484,930.579042745903,90,160,70
"186","2005-06",0.0580472931927894,366.943894385232,741.4038688762,40,274,234
"187","2005-07",0.0581601826270774,441.960712768794,530.951758208562,0,600,600
"188","2005-08",0.0582568002812512,429.459798158505,503.157060948267,1,470,469
"189","2005-09",0.0583303221787703,381.446994608459,575.310795954549,53,210,157
"190","2005-10",0.0583896096975434,391.191064256681,727.697034652222,171,32,-139
"191","2005-11",0.0584677928775495,472.599755095195,1123.7422723845,454,0,-454
"192","2005-12",0.0585077702854445,603.039328683869,2486.63201153322,754,0,-754
"193","2006-01",0.0585457185638777,591.261405832456,2750.59497326519,661,0,-661
"194","2006-02",0.0585594191449499,581.1726791795,2399.9971738858,518,0,-518
"195","2006-03",0.0585684800372736,555.448323452232,2301.38300755238,582,0,-582
"196","2006-04",0.0585442078344999,420.300562275286,1469.75572258043,263,10,-253
"197","2006-05",0.0585036901614731,356.839796068497,798.432044930561,68,199,131
"198","2006-06",0.0584267540020775,363.893608075849,664.161746838449,7,429,422
"199","2006-07",0.0583227377647654,439.278199238849,540.672492539188,0,604,604
"200","2006-08",0.0582054099142846,415.463123859721,499.915547780097,0,457,457
"201","2006-09",0.0580535503283153,359.480523954997,559.224245715847,42,228,186
"202","2006-10",0.0578970419689598,400.801066305337,813.775815444881,216,29,-187
"203","2006-11",0.0577301116875786,489.549843156107,1220.12853389612,429,0,-429
"204","2006-12",0.0575294615181186,592.252981039317,2625.7144925753,752,0,-752
"205","2007-01",0.0573264121635095,650.433388760913,3479.62494761642,825,0,-825
"206","2007-02",0.0571392091325043,646.113225336161,2566.54793614612,510,0,-510
"207","2007-03",0.056959572940988,537.076681258984,1738.99747836324,308,16,-292
"208","2007-04",0.0567645435700844,451.588189420657,1045.61267137614,219,55,-164
"209","2007-05",0.0565739426690945,349.755098096446,839.677398703316,64,193,129
"210","2007-06",0.0563718345865255,355.996159805174,634.469752426988,14,391,377
"211","2007-07",0.0561586380526839,435.701012056695,539.190908261781,0,609,609
"212","2007-08",0.0559432726442377,416.368918146822,489.253315993054,0,516,516
"213","2007-09",0.0557275752008172,361.5833063651,535.50430936908,54,259,205
"214","2007-10",0.055522102391846,372.836549919818,793.017963437328,174,28,-146
"215","2007-11",0.0553140175972028,478.409867926639,1110.14218999144,368,1,-367
"216","2007-12",0.055114263462587,649.51826990501,2451.70836771298,813,0,-813
"217","2008-01",0.0549281062417222,701.603765225147,3467.00578512837,813,0,-813
"218","2008-02",0.0547130357306048,682.064276651119,2847.79604769762,596,0,-596
"219","2008-03",0.0544610147440257,598.097558784751,1848.07217198562,418,0,-418
"220","2008-04",0.0541865789656688,450.738786627969,1160.10644788537,259,10,-249
"221","2008-05",0.0538597006607146,370.133054627941,817.065523272834,125,105,-20
"222","2008-06",0.0535020493128311,319.307532742395,676.030138203888,28,378,350
"223","2008-07",0.0531028801017618,382.557132086335,525.663712994208,0,567,567
"224","2008-08",0.0526624901892864,407.609833474639,475.533033051238,1,532,531
"225","2008-09",0.0521925379638099,353.166698934485,510.037339319313,19,305,286
"226","2008-10",0.0516952535442904,370.046182407527,699.660963541631,161,67,-94
"227","2008-11",0.0511689881668204,507.487258494875,1035.02887595675,353,1,-352
"228","2008-12",0.0506232956194132,720.996085184056,2093.04872496033,788,0,-788
"229","2009-01",0.0500363093313791,793.81025124738,3097.49464220754,651,0,-651
"230","2009-02",0.0495162447690441,677.368110396183,2348.18813371989,583,0,-583
"231","2009-03",0.0490465255405556,637.706657594588,1907.86168347649,471,0,-471
"232","2009-04",0.0486382631425942,493.344478096961,1233.82263239456,292,24,-268
"233","2009-05",0.0482780057456372,395.006546289772,771.738894653024,53,255,202
"234","2009-06",0.0479691772439446,350.429855623247,610.554905172255,34,260,226
"235","2009-07",0.0477113797216307,365.797693283784,525.679329201152,2,583,581
"236","2009-08",0.0475072341618759,368.792446118184,473.131615493031,7,472,465
"237","2009-09",0.0473478869988419,363.937023978771,499.193009981566,11,343,332
"238","2009-10",0.0472486281140793,435.101958001841,701.183824616325,243,23,-220
"239","2009-11",0.0472092671845158,488.598925530223,1186.66534036552,434,0,-434
"240","2009-12",0.0472426331467131,691.722291318108,2648.68735268021,868,0,-868
"241","2010-01",0.0473222891173428,745.052526613513,3043.39119710975,713,0,-713
"242","2010-02",0.0474004397392784,651.886598153751,2408.11332190678,565,0,-565
"243","2010-03",0.0474794977099575,554.289242093985,1922.58943673133,493,0,-493
"244","2010-04",0.0475521014806044,416.823426615946,1317.54362180293,338,6,-332
"245","2010-05",0.0476199137569195,358.173193074442,923.841823411012,183,41,-142
"246","2010-06",0.0476845550491548,351.028582899391,682.085812883963,30,344,314
"247","2010-07",0.0477358134477521,410.845738586484,503.068773303499,1,595,594
"248","2010-08",0.047775058863096,433.626377295388,443.706893985445,9,468,459
"249","2010-09",0.0478034566538565,359.622779021784,493.528533065451,30,308,278
"250","2010-10",0.0478273191528157,362.609143715044,612.51097895051,174,78,-96
"251","2010-11",0.0478635441657845,507.439838032385,1270.21003790636,529,3,-526
"252","2010-12",0.0478992261845894,702.960279863692,2310.1128551674,638,0,-638
"253","2011-01",0.0479230574684741,764.579070396903,2992.86464222152,706,0,-706
"254","2011-02",0.0479470134979919,661.20542595624,2391.2818637905,635,0,-635
"255","2011-03",0.0479626965925688,643.942598179638,1842.70722348511,448,1,-447
"256","2011-04",0.0479470060221602,473.030268927938,1188.04177121097,297,13,-284
"257","2011-05",0.0479174507818488,395.002828042077,828.233753689135,191,50,-141
"258","2011-06",0.0478757120597107,348.520484100163,660.736794462134,48,272,224
"259","2011-07",0.0478029418714456,427.125318419759,513.583212075245,0,466,466
"260","2011-08",0.0477143934256678,420.200873960637,473.787336886864,0,510,510
"261","2011-09",0.0476004247506861,371.959823110631,486.037119711884,9,295,286
"262","2011-10",0.0474814536134358,379.620467864315,647.295876704188,173,69,-104
"263","2011-11",0.0473567144784731,499.551999400568,1514.41274383753,541,0,-541
"264","2011-12",0.0472167950428124,644.409052621,2755.67560033419,768,0,-768
"265","2012-01",0.0470595664373311,665.409851006742,2860.99783649843,639,0,-639
"266","2012-02",0.0469361372621642,621.91095708127,2318.09051572058,576,0,-576
"267","2012-03",0.0468110753455514,518.20459315965,1722.01612999392,432,0,-432
"268","2012-04",0.0467016505963483,397.799607374039,1080.58613419758,234,62,-172
"269","2012-05",0.0466073155376086,356.605213696641,704.832287343715,81,209,128
"270","2012-06",0.0465151103624712,352.737688828222,596.850799336925,29,383,354
"271","2012-07",0.0464312529090912,482.045876451403,545.781795383333,0,514,514
"272","2012-08",0.0463506386121702,427.268621067724,417.183090869625,0,553,553
"273","2012-09",0.0462754915046137,357.669471239269,473.871941666503,6,340,334
"274","2012-10",0.0462198066849197,413.198368681424,597.204313623701,147,90,-57
"275","2012-11",0.0461834046797205,535.345640105911,1239.24179110407,366,2,-364
"276","2012-12",0.0461666621917863,737.901117432595,2158.3911638115,712,0,-712
"277","2013-01",0.046167287415578,771.702696066114,3590.1218553268,837,0,-837
"278","2013-02",0.0461782328614126,700.618802327141,2401.4519767277,589,0,-589
"279","2013-03",0.0461770237803072,644.860868255673,1603.2699829896,317,7,-310
"280","2013-04",0.0461622269115155,551.223196108603,972.876430176544,200,45,-155
"281","2013-05",0.0461496682841561,417.186547632865,684.776857599401,85,160,75
"282","2013-06",0.0461097547133259,361.488998074786,547.076612872267,19,440,421
"283","2013-07",0.0460696004037514,458.613739842606,474.764981929673,0,597,597
"284","2013-08",0.0460156332127453,410.478079833157,432.649257611545,0,474,474
"285","2013-09",0.0459476388090175,384.007573463462,485.463851196648,41,252,211
"286","2013-10",0.0458778151298286,414.257350699961,861.783176048164,234,16,-218
"287","2013-11",0.0458044734246782,594.706764476597,1328.02535215337,434,0,-434
"288","2013-12",0.0457420071366896,801.408676544073,2942.79585998149,786,0,-786
"289","2014-01",0.0456712509134369,873.63871863923,2673.95490557873,568,0,-568
"290","2014-02",0.0456304816792163,804.890738571776,2018.81377363225,444,0,-444
"291","2014-03",0.0456149560762924,707.885959647608,1368.812061545,352,0,-352
"292","2014-04",0.0456160980752951,571.166318951666,1000.32392141318,211,35,-176
"293","2014-05",0.0456311925555926,441.558095069917,704.879719668719,86,162,76
"294","2014-06",0.0456648177215711,382.857086125338,554.924287366863,15,378,363
"295","2014-07",0.0457175840323151,414.756997844768,484.368724883908,0,589,589
"296","2014-08",0.0457742532056569,423.314481639817,449.249209859376,1,425,424
"297","2014-09",0.0458530263818284,384.662950085771,463.028016616221,19,322,303
"298","2014-10",0.0459538118170793,442.237337198991,596.344206653378,95,96,1
"299","2014-11",0.0460807865695927,624.95689253226,1153.98060283165,419,0,-419
"300","2014-12",0.0462383736823401,742.865667546681,2085.71241134067,647,0,-647
"301","2015-01",0.0464191372083196,773.773024623587,2688.33165663569,591,0,-591
"302","2015-02",0.0465943883935795,717.619377745942,1633.97084388792,360,0,-360
"303","2015-03",0.0467404484118164,603.856663919405,1288.25322510298,256,14,-242
"304","2015-04",0.0468575259231604,450.815204941578,899.491414655411,228,28,-200
"305","2015-05",0.0469492433317127,375.547652676249,721.672821517084,124,84,-40
"306","2015-06",0.0470166848817892,370.602209438543,567.453017939177,6,459,453
"307","2015-07",0.0470546252815863,439.886356659988,423.839023866148,1,475,474
"308","2015-08",0.0470636647284436,443.951367048527,449.127090495251,0,532,532
"309","2015-09",0.0470504537007207,373.09997892645,462.999233165933,21,359,338
"310","2015-10",0.0470123188328483,383.740261042967,545.266780304285,90,100,10
"311","2015-11",0.0469678841654848,498.943232660471,1584.67879986565,560,0,-560
"312","2015-12",0.0468955400212241,643.380168597174,2754.20326290834,765,0,-765
"313","2016-01",0.0468226626636464,740.665947033988,3198.43206960853,731,0,-731
"314","2016-02",0.0467712210796134,600.290353363358,2116.28634145888,427,0,-427
"315","2016-03",0.0467343744553413,506.591641556689,1316.23397854637,319,2,-317
"316","2016-04",0.0467133395147264,434.142971336218,932.370189026539,178,25,-153
"317","2016-05",0.0467081378137867,355.344897758412,742.118516462005,96,122,26
"318","2016-06",0.0467205936276571,369.322155196887,564.338349018584,12,499,487
"319","2016-07",0.046743638171958,421.951116514927,470.923832852509,3,605,602
"320","2016-08",0.046784336364457,446.707195114438,447.469400864268,0,578,578
"321","2016-09",0.0468426537985706,349.564025436593,512.822446674284,23,292,269
"322","2016-10",0.0469157442892632,405.40084118666,667.920516682697,111,91,-20
"323","2016-11",0.0470197455762146,464.115126722836,1065.02970060755,347,4,-343
"324","2016-12",0.0471485296581882,714.662893095052,2492.72294248864,730,0,-730
"325","2017-01",0.0472911724950418,752.925789559159,3149.93069116005,738,0,-738
"326","2017-02",0.0474326925370503,585.918498639561,2294.31836371562,454,0,-454
"327","2017-03",0.0475505445294004,571.715911481175,1609.94924289433,293,24,-269
"328","2017-04",0.0476471522524282,411.595247927598,1021.7761298832,194,23,-171
"329","2017-05",0.0477178003373282,347.093598208667,738.276660337837,92,169,77
"330","2017-06",0.047766710965512,345.721760409572,583.227875669748,23,464,441
"331","2017-07",0.0477888516833466,425.634847571666,476.64503841375,0,628,628
"332","2017-08",0.0477875524188808,381.696378353143,418.709887144185,0,549,549
"333","2017-09",0.0477672210922125,341.714179724423,534.963484152497,62,288,226
"334","2017-10",0.0477282092584367,376.86782919298,736.125785761216,145,54,-91
"335","2017-11",0.0476792007720386,543.141189356824,1073.51087547856,312,0,-312
"336","2017-12",0.0476179447188743,663.529485998859,2276.82935348346,627,0,-627
