"","Date","Real GDP per capita (millions of chained 2012 dollars per person)","Electricity Sale to Residential Consumers per capita (MJ/person)","Natural Gas Deliveries to Residential Consumers per capita (MJ/person)","HDD","CDD","DD"
"1","1990-01",0.0246588743876418,266.678919534419,1397.9917079116,561,0,-561
"2","1990-02",0.0246136199236963,210.841447545426,802.702650638662,426,3,-423
"3","1990-03",0.0245652410155432,211.809147020672,718.578092539155,366,25,-341
"4","1990-04",0.0244973546464924,169.216438061235,536.76532338892,220,33,-187
"5","1990-05",0.024436458863536,220.4130416439,260.707990958205,38,105,67
"6","1990-06",0.0243718833432883,302.91761697455,155.240478709464,0,291,291
"7","1990-07",0.0243076516449281,350.175293782342,123.544219864262,0,433,433
"8","1990-08",0.0242412206855266,332.227066103703,118.312396174546,0,383,383
"9","1990-09",0.0241743826857641,267.45166364701,121.340764691185,29,211,182
"10","1990-10",0.0241089691511787,194.262362345622,172.39470805684,148,72,-76
"11","1990-11",0.0240555358867936,198.467729808549,480.516519455723,362,0,-362
"12","1990-12",0.0240039876794109,270.501621723824,804.0363821732,535,1,-534
"13","1991-01",0.0239564527912921,313.081511385259,1137.44198932242,718,0,-718
"14","1991-02",0.0239208476716727,211.151092485536,1095.93158228175,533,1,-532
"15","1991-03",0.023905680238315,219.536863454562,888.162014180978,382,14,-368
"16","1991-04",0.0239009591963362,197.238045345526,475.581413548308,155,51,-104
"17","1991-05",0.023904044465114,189.291116843885,238.86065477853,17,217,200
"18","1991-06",0.0239144065984496,255.31633172444,148.99864621335,3,300,297
"19","1991-07",0.0239591520778059,347.930357950754,119.594492682439,0,459,459
"20","1991-08",0.024016842732088,353.747200014397,120.73209199116,0,351,351
"21","1991-09",0.0240906581396305,278.312671962369,124.730452227592,34,206,172
"22","1991-10",0.0241846284214584,235.797410862168,236.75361825333,169,27,-142
"23","1991-11",0.0243015027070712,214.840162101894,597.081831059784,488,2,-486
"24","1991-12",0.0244432238719279,267.792955205207,898.347652676828,595,7,-588
"25","1992-01",0.0246030407890568,292.10858234374,1204.04990714498,701,0,-701
"26","1992-02",0.0247488573847978,232.689489621188,1170.48852153377,549,0,-549
"27","1992-03",0.0248753065761728,209.780317919137,824.728614128878,479,0,-479
"28","1992-04",0.0249790244430648,194.75748708306,715.187692829037,241,39,-202
"29","1992-05",0.0250660727895636,235.688111746667,352.028270379051,115,59,-56
"30","1992-06",0.0251347093914964,285.752174322237,205.843375789065,8,203,195
"31","1992-07",0.0251872643566758,353.56204562709,132.246241619777,0,456,456
"32","1992-08",0.0252179941841472,394.237641764183,115.777625099834,0,282,282
"33","1992-09",0.0252365270155027,299.109877559447,126.932161619416,24,205,181
"34","1992-10",0.0252405967754366,227.268227552206,280.030751903751,238,7,-231
"35","1992-11",0.0252339561755431,199.346133938947,541.031791809257,415,5,-410
"36","1992-12",0.0252161122864622,270.878094718431,1069.1654804206,717,0,-717
"37","1993-01",0.0251825439893452,326.509145101187,1311.91390698585,672,0,-672
"38","1993-02",0.0251722232273229,228.79541859283,1272.95873442443,692,0,-692
"39","1993-03",0.0251808409961011,222.346201756737,1253.35012640954,557,0,-557
"40","1993-04",0.0252028336836249,178.94389081772,784.623033976835,266,5,-261
"41","1993-05",0.0252419574644359,235.436981566885,307.962209984307,29,126,97
"42","1993-06",0.0252961337935352,290.231336153963,161.605363415085,1,310,309
"43","1993-07",0.0253667241205787,396.865997383452,128.742218488016,0,518,518
"44","1993-08",0.0254517332508585,375.619371500454,117.983612236432,0,379,379
"45","1993-09",0.0255565811852598,295.614019017522,126.154790054794,18,249,231
"46","1993-10",0.0256800067857808,205.524909633145,225.490731661866,206,24,-182
"47","1993-11",0.0258275213656438,201.26585939719,604.751662859774,445,10,-435
"48","1993-12",0.0259953315180835,297.057428199103,1038.02622317878,775,0,-775
"49","1994-01",0.0261813711723937,289.445968510691,1706.39440624102,898,0,-898
"50","1994-02",0.0263615556437905,236.302094011556,1459.64965861426,618,0,-618
"51","1994-03",0.0265236701016039,211.451848359091,1017.90990507684,425,3,-422
"52","1994-04",0.0266625248871859,200.942204213643,540.365238964894,145,46,-99
"53","1994-05",0.0267944388962841,216.747388591913,261.189665147866,108,68,-40
"54","1994-06",0.026907509389941,380.555919492283,184.587665490306,0,334,334
"55","1994-07",0.0270055055355786,464.034450027761,132.344871628047,0,412,412
"56","1994-08",0.0270887301914719,421.954233244137,122.977966054687,0,300,300
"57","1994-09",0.0271575860922811,328.32062159263,137.549173466301,20,115,95
"58","1994-10",0.0272151226810275,201.81571174959,238.460826430463,216,9,-207
"59","1994-11",0.0272645794893809,218.480250705773,555.050364553804,345,2,-343
"60","1994-12",0.0273033591556371,318.751375154971,914.464913803379,580,0,-580
"61","1995-01",0.0273302594063254,290.837015966295,1373.33540908758,739,0,-739
"62","1995-02",0.0273697607421664,208.983984780683,1456.91869720135,704,0,-704
"63","1995-03",0.02741997138964,210.282267538764,1044.80781698209,408,1,-407
"64","1995-04",0.0274734506950661,199.458221067187,549.685369522871,198,38,-160
"65","1995-05",0.0275404322872643,215.56448239986,283.50737314154,53,119,66
"66","1995-06",0.0276120722013414,292.091523541176,164.696174235541,3,236,233
"67","1995-07",0.0276908972591782,429.902130090339,146.554990102001,0,426,426
"68","1995-08",0.0277795147715129,461.727602491386,119.778159015998,0,420,420
"69","1995-09",0.0278741713621238,350.104004513178,140.363674467426,22,151,129
"70","1995-10",0.0279794175224452,223.604956888143,209.427633248161,159,50,-109
"71","1995-11",0.028103254808772,192.903637881146,663.023922753125,581,2,-579
"72","1995-12",0.0282429546792194,257.982961887168,1278.38327775832,834,0,-834
"73","1996-01",0.0283963909412168,296.772230087854,1895.47041920932,839,0,-839
"74","1996-02",0.0285115614972629,229.914896560333,1741.93482816178,675,0,-675
"75","1996-03",0.0285852516428889,229.116227491993,1097.39068845658,611,0,-611
"76","1996-04",0.0286161237206139,205.314743017953,917.671665627275,240,21,-219
"77","1996-05",0.0286105615693497,281.860584479402,315.560734779814,69,159,90
"78","1996-06",0.0285635232508043,384.313325360135,178.921506956667,5,290,285
"79","1996-07",0.0284783541047233,501.869372963734,131.265280996741,0,391,391
"80","1996-08",0.0283510261803248,489.922614562942,127.073593213422,0,305,305
"81","1996-09",0.0281869336345941,341.967676310397,134.377671273779,16,161,145
"82","1996-10",0.0279886844309885,238.799233904083,249.985678462265,178,12,-166
"83","1996-11",0.0277543286234801,223.466763524511,654.653638506738,582,2,-580
"84","1996-12",0.0274931304345529,283.581207457582,1261.70532713981,649,0,-649
"85","1997-01",0.0271978302204205,313.423977392837,1469.00091378265,767,0,-767
"86","1997-02",0.0270837155122534,238.596235287423,1460.56720252969,540,2,-538
"87","1997-03",0.0271459355650891,233.579842116598,847.642819550732,332,7,-325
"88","1997-04",0.0273812208592143,207.726111541711,595.482725542975,315,7,-308
"89","1997-05",0.0277946671647986,332.33013757,435.227099620505,108,47,-61
"90","1997-06",0.028380839679845,389.205254894457,232.272239659643,42,221,179
"91","1997-07",0.0291404570448133,452.106261792191,155.756535799064,0,408,408
"92","1997-08",0.0300671634930489,475.806821016056,130.223210007622,0,312,312
"93","1997-09",0.0311685913639738,376.715829181932,135.183882035112,18,176,158
"94","1997-10",0.0324454309921282,240.912757480366,207.744998055151,215,45,-170
"95","1997-11",0.0338994438351257,211.92963493283,703.071665076824,550,0,-550
"96","1997-12",0.0355303923943533,307.685504120943,1325.01541896116,737,0,-737
"97","1998-01",0.0373293490939948,321.625536571555,1551.93527689698,648,2,-646
"98","1998-02",0.0389680364633964,245.450018738199,1412.21912865126,549,0,-549
"99","1998-03",0.0404393167989199,261.371128311219,1094.82474658101,494,12,-482
"100","1998-04",0.041729878351636,222.399521306091,728.239772628676,201,22,-179
"101","1998-05",0.042852653954009,236.80712757409,325.190084013915,28,157,129
"102","1998-06",0.0438064665317642,312.9395749407,172.607074699695,9,359,350
"103","1998-07",0.0445927228879498,526.446615573548,151.186591697687,0,437,437
"104","1998-08",0.0452081970394815,539.368457787529,130.516831660373,0,373,373
"105","1998-09",0.045662419065376,367.150697183768,138.876522251556,8,271,263
"106","1998-10",0.0459554355983846,232.581274621143,173.660194283071,148,30,-118
"107","1998-11",0.0460905905293816,222.760772471033,579.655333791008,395,0,-395
"108","1998-12",0.0460710851633459,314.879960411115,818.727435572168,563,5,-558
"109","1999-01",0.0458844317730792,325.886916940999,1596.99057853826,630,0,-630
"110","1999-02",0.0457219744748356,251.751982606812,1066.08032762649,571,0,-571
"111","1999-03",0.0455640922627706,251.076278903122,1346.26335693259,566,0,-566
"112","1999-04",0.0453983127803485,228.535786056486,759.425017501198,160,44,-116
"113","1999-05",0.0452356587539289,276.398455470516,369.603118260667,47,84,37
"114","1999-06",0.0450745234522675,401.86487033016,186.195336447291,2,244,242
"115","1999-07",0.0449178377676609,524.84004691858,150.186665640563,2,446,444
"116","1999-08",0.0447645505928416,486.723267869542,129.696794362526,0,424,424
"117","1999-09",0.0446200788312304,405.663782185388,144.909751386048,26,146,120
"118","1999-10",0.0444844147270669,277.652366636378,234.035779913652,211,17,-194
"119","1999-11",0.0443652459366084,202.437162090479,546.296076816199,315,1,-314
"120","1999-12",0.0442599558197879,312.846705581042,951.917283253478,670,0,-670
"121","2000-01",0.0441583007528865,317.533113394035,1506.92086063824,816,0,-816
"122","2000-02",0.0440827112614451,244.696161281936,1789.08896885481,567,0,-567
"123","2000-03",0.044018266953764,262.827168753967,1020.84521825209,356,6,-350
"124","2000-04",0.0439541000767888,237.923220832183,598.752648120175,235,6,-229
"125","2000-05",0.0439133959034518,349.017406867083,298.03320993766,23,170,147
"126","2000-06",0.0438781330691148,475.731144967367,197.883432403746,3,325,322
"127","2000-07",0.0438461910404135,552.290938703208,133.90541858401,0,347,347
"128","2000-08",0.0438295695680816,556.452991054182,133.929151163229,0,327,327
"129","2000-09",0.0438210860204205,352.457764963781,139.176928140394,42,172,130
"130","2000-10",0.0438253219883404,284.077315507368,323.573300080738,180,23,-157
"131","2000-11",0.0438472605018549,244.274582712746,787.533786936581,530,3,-527
"132","2000-12",0.0438798237660489,309.527212354923,1651.47519922067,936,0,-936
"133","2001-01",0.0439316563748951,332.641122105831,1939.74464731589,801,0,-801
"134","2001-02",0.0439810850633766,265.404348656435,1261.4599882629,530,0,-530
"135","2001-03",0.0440214778217468,252.094236898115,1016.18723675101,550,0,-550
"136","2001-04",0.0440511304639502,250.319199199622,664.672207342627,201,61,-140
"137","2001-05",0.0440757185807454,343.712995783744,268.989478011346,33,96,63
"138","2001-06",0.0440878845804732,469.803904937147,145.081169141772,0,304,304
"139","2001-07",0.0440940837526474,517.912176299724,142.99224480283,0,322,322
"140","2001-08",0.044090192385498,540.012822404968,124.695179798383,0,388,388
"141","2001-09",0.0440764987985798,428.174425009239,142.669907295768,49,148,99
"142","2001-10",0.0440762323582328,295.860647129824,329.959370431693,247,25,-222
"143","2001-11",0.044060378098572,206.854414141992,601.915087960857,317,5,-312
"144","2001-12",0.0440421276758496,313.258117642643,843.402910087092,537,1,-536
"145","2002-01",0.0440221404707714,330.105692305312,1550.07944679969,702,1,-701
"146","2002-02",0.044007235345118,275.998588799633,1243.56432900809,592,1,-591
"147","2002-03",0.0440033062071831,298.758074686229,1021.62093404576,446,4,-442
"148","2002-04",0.043997892860461,252.812974071174,532.756130065397,148,85,-63
"149","2002-05",0.0439934516394474,245.351544926602,229.286729486235,90,114,24
"150","2002-06",0.0439890344371516,463.137052144293,221.436298414583,0,323,323
"151","2002-07",0.0439924955121667,596.27335644895,131.52492389947,0,457,457
"152","2002-08",0.0439975329093441,573.887217883766,114.642277206483,0,394,394
"153","2002-09",0.044004062425451,400.453133664535,134.539976848594,1,231,230
"154","2002-10",0.0440183786382116,238.958257793236,265.000948083771,165,79,-86
"155","2002-11",0.0440424292500843,225.803080077969,806.017592796379,510,3,-507
"156","2002-12",0.0440813570200193,297.696805333333,1404.51815935687,768,0,-768
"157","2003-01",0.044125339688402,321.678302684955,1812.32587638723,895,0,-895
"158","2003-02",0.044190336233214,243.917836237822,1660.32445691056,671,0,-671
"159","2003-03",0.0442628135620002,262.027997808949,1059.65369964457,389,1,-388
"160","2003-04",0.0443366425451345,225.495665249444,611.784999732308,224,8,-216
"161","2003-05",0.0444124311612749,296.595823494612,324.610267168163,49,88,39
"162","2003-06",0.0444648645781931,530.510580351357,186.758957131741,4,245,241
"163","2003-07",0.0445164457439439,633.532186690088,145.832175342888,0,377,377
"164","2003-08",0.0445745863575716,587.390383992896,128.589911972884,0,398,398
"165","2003-09",0.0446428918093216,428.842826636246,147.604313494048,15,166,151
"166","2003-10",0.0447178517085725,330.755117737751,292.519284188744,191,10,-181
"167","2003-11",0.0448021589038687,232.524835483801,666.341501265442,301,20,-281
"168","2003-12",0.044902091608892,328.53070401878,1361.89188793021,773,0,-773
"169","2004-01",0.0450112402838538,344.925911305402,1785.0757076899,847,0,-847
"170","2004-02",0.0451263754652432,296.187756834489,1718.72735788427,733,0,-733
"171","2004-03",0.0452388812321451,279.146199405396,1084.35943955704,408,5,-403
"172","2004-04",0.0453378872286775,227.548219376712,624.774177971314,220,38,-182
"173","2004-05",0.0454306369420541,349.900828534626,247.635608883977,28,237,209
"174","2004-06",0.0455280246030856,474.839136980574,155.524702819566,0,301,301
"175","2004-07",0.0456215861057489,607.17311471753,141.037359605053,0,401,401
"176","2004-08",0.0457095960333984,618.238950259011,132.256244720337,1,294,293
"177","2004-09",0.0457971313605587,422.958223106484,126.526346988561,9,172,163
"178","2004-10",0.0458806478051691,295.184416035766,201.547452475434,130,31,-99
"179","2004-11",0.0459730871374241,245.011971623501,530.425543860846,378,13,-365
"180","2004-12",0.0460686750185045,341.660015275837,1213.44977561098,742,0,-742
"181","2005-01",0.0461632261822661,357.319239045701,1581.70288790784,699,0,-699
"182","2005-02",0.0462888440176496,274.745552290833,1454.69211108396,612,0,-612
"183","2005-03",0.0464205017252401,276.963767639356,1210.4552085563,572,0,-572
"184","2005-04",0.0465531185467348,248.305949313255,664.421407482724,236,11,-225
"185","2005-05",0.0466935673101023,309.422564332782,346.106505114027,89,47,-42
"186","2005-06",0.0468513048453637,493.16597496513,180.824210976394,5,266,261
"187","2005-07",0.0470163407346472,695.31723554614,149.757064349478,0,457,457
"188","2005-08",0.0471941212453372,621.650754570071,127.240193409091,0,422,422
"189","2005-09",0.0473813043658525,447.081870577427,134.802105950821,1,266,265
"190","2005-10",0.0475817862343566,294.562603219728,213.365603476646,167,58,-109
"191","2005-11",0.0478108757141818,227.144045219901,585.47907367299,408,2,-406
"192","2005-12",0.0480417731042328,354.126912373918,1318.61307202522,797,0,-797
"193","2006-01",0.0482912115902478,351.058273129834,1344.673331384,570,0,-570
"194","2006-02",0.0485022759163329,275.064587133912,1184.68772335681,631,0,-631
"195","2006-03",0.0486844269438879,301.70092583841,955.033866368378,454,7,-447
"196","2006-04",0.0488241372660885,261.754230098691,540.041738828798,130,47,-83
"197","2006-05",0.04892966867216,382.355515209493,229.466088292239,81,89,8
"198","2006-06",0.0489914252540178,552.445578874443,172.824358678451,1,271,270
"199","2006-07",0.0490139674724317,731.898175661168,142.916552713807,0,422,422
"200","2006-08",0.0490040693618078,661.387808766228,118.96623582277,0,434,434
"201","2006-09",0.0489515493493685,472.265143888259,139.67696091724,23,144,121
"202","2006-10",0.0488710482371244,276.650525704285,290.065664984212,223,20,-203
"203","2006-11",0.0487599016857108,233.681990881906,718.609706312999,392,0,-392
"204","2006-12",0.0486068474769004,361.315688220168,1056.2056817892,554,1,-553
"205","2007-01",0.0484272933346222,393.067713306494,1276.83784694351,632,0,-632
"206","2007-02",0.0482849892439706,286.339989358738,1542.41808039147,723,0,-723
"207","2007-03",0.0481757666581549,285.656104884706,971.959210687505,331,15,-316
"208","2007-04",0.0480882381893618,268.080719305075,527.15615593999,236,35,-201
"209","2007-05",0.048031974743853,384.39249195492,291.510993748557,45,113,68
"210","2007-06",0.0479989801175022,543.112322882044,156.224763311756,0,308,308
"211","2007-07",0.0479892522135621,754.252823498348,137.353870052678,0,369,369
"212","2007-08",0.0480070027987632,647.084950965762,117.956946279059,0,522,522
"213","2007-09",0.048052965483713,520.958424683024,124.833952820623,5,254,249
"214","2007-10",0.048132277311704,250.91079886864,160.447511623071,88,117,29
"215","2007-11",0.0482383533942528,235.358521683977,606.288049840001,448,0,-448
"216","2007-12",0.0483765730848546,351.073680013555,1054.58425706356,528,0,-528
"217","2008-01",0.0485495492170579,388.163405513633,1523.50074636829,761,0,-761
"218","2008-02",0.0486756989263436,309.65958852257,1198.44956074175,553,1,-552
"219","2008-03",0.0487511135191914,271.716975349437,813.73679463886,412,0,-412
"220","2008-04",0.0487835572639307,246.094814776512,434.18520970834,182,18,-164
"221","2008-05",0.0487575611329048,314.321618962737,177.882050339992,29,97,68
"222","2008-06",0.0486845829952734,463.586970213509,130.920221131462,0,405,405
"223","2008-07",0.048559128389385,713.779197699752,123.390537181296,0,404,404
"224","2008-08",0.0483814646467576,655.157428512224,119.025341497182,0,362,362
"225","2008-09",0.0481579247212265,484.550729409846,161.444315940663,10,208,198
"226","2008-10",0.0478898773936995,310.730354182891,382.938463072851,219,22,-197
"227","2008-11",0.0475766075064095,222.482140314727,1105.41754200738,520,1,-519
"228","2008-12",0.0472234127440106,313.946685915217,1297.33479495427,568,0,-568
"229","2009-01",0.0468186477185525,366.604943887142,1724.55891829816,794,0,-794
"230","2009-02",0.0464594427578212,265.004679850767,1229.36272341267,600,0,-600
"231","2009-03",0.0461367142455209,276.39645798845,955.520280637385,471,5,-466
"232","2009-04",0.0458563654437769,248.912981063756,374.82471674796,180,32,-148
"233","2009-05",0.0456109745072851,375.193338392143,151.803409015463,36,156,120
"234","2009-06",0.0454022844853979,454.659443368999,86.9208528610626,0,340,340
"235","2009-07",0.0452299746416391,632.513193133943,110.724711258822,0,357,357
"236","2009-08",0.045095387536261,619.674670268668,108.810382504928,0,414,414
"237","2009-09",0.044993597694638,480.179913478501,129.350596192299,9,177,168
"238","2009-10",0.0449329161293726,279.847848290672,315.847623494477,188,21,-167
"239","2009-11",0.0449132010285075,219.526737751526,733.135249647078,359,1,-358
"240","2009-12",0.0449414688946439,340.291249376239,1636.30919536272,742,0,-742
"241","2010-01",0.0450031693400362,341.568460835784,1960.24217388068,856,0,-856
"242","2010-02",0.0450631578514205,266.335569251989,1669.03057125694,770,0,-770
"243","2010-03",0.0451227350008829,260.072150380481,860.299733633684,442,0,-442
"244","2010-04",0.045177832574124,236.375561308536,219.038904494719,118,44,-74
"245","2010-05",0.0452293443539469,269.231856814346,141.361696812314,24,207,183
"246","2010-06",0.0452781433208797,440.589563127007,106.215513813245,0,445,445
"247","2010-07",0.0453186091883216,660.632398146426,99.4321287430457,0,482,482
"248","2010-08",0.0453514874451558,626.552757430934,101.66922143137,0,459,459
"249","2010-09",0.0453774139012301,426.693015689051,113.568782031471,1,276,275
"250","2010-10",0.0453998510441461,298.137728341136,210.182605004346,139,40,-99
"251","2010-11",0.0454280648639148,222.184404281428,786.105476713212,438,0,-438
"252","2010-12",0.045454969363187,317.133837062304,2148.238769171,949,0,-949
"253","2011-01",0.0454743730927975,338.323365165512,1905.65001813179,876,0,-876
"254","2011-02",0.045495406723696,261.150045877651,1090.26465894003,521,0,-521
"255","2011-03",0.0455134821058755,269.902997652454,828.531222379573,442,4,-438
"256","2011-04",0.0455159855029823,239.154798202112,323.465217054133,136,53,-83
"257","2011-05",0.0455124988042453,276.831234750563,150.800768460183,45,158,113
"258","2011-06",0.0455039431171599,379.533451206772,107.565102990482,0,395,395
"259","2011-07",0.0454799990930143,619.586966751454,99.3301045730998,0,499,499
"260","2011-08",0.0454489887963745,596.014826649514,119.014137957407,0,431,431
"261","2011-09",0.04540559447119,471.785629223863,116.894277894788,15,219,204
"262","2011-10",0.0453609902587036,285.964498605475,313.38121782422,210,15,-195
"263","2011-11",0.0453147512876214,222.478848671891,777.488794435855,371,2,-369
"264","2011-12",0.0452616730713999,320.824668877726,1057.6689802981,548,0,-548
"265","2012-01",0.0452005354764328,335.221754567474,1455.22971214163,628,0,-628
"266","2012-02",0.045158711933523,261.047185704422,1122.57749919418,542,0,-542
"267","2012-03",0.0451165883986825,269.528438228934,456.547754324936,201,30,-171
"268","2012-04",0.0450837559006537,241.825139905795,260.541297857625,175,25,-150
"269","2012-05",0.0450599326703659,361.731772186356,160.931952950309,13,196,183
"270","2012-06",0.0450378904782631,490.056569265078,125.689841214399,2,258,256
"271","2012-07",0.0450210932609459,622.158408819349,99.6868372400568,0,502,502
"272","2012-08",0.045006674888222,628.991661577049,125.44985678473,0,364,364
"273","2012-09",0.0449958693033213,458.152591419766,112.064041699219,12,183,171
"274","2012-10",0.0449965482044314,300.056393472775,298.465954093965,185,33,-152
"275","2012-11",0.0450086357174515,205.07776720789,1012.61028892633,538,0,-538
"276","2012-12",0.0450323627420726,299.41009548088,1026.32844522496,525,0,-525
"277","2013-01",0.0450664471047181,378.436724979456,1344.32474532083,634,0,-634
"278","2013-02",0.0451080070888448,264.528865713395,1332.17745332406,643,0,-643
"279","2013-03",0.0451443488764539,258.131016583816,1276.20317758127,607,0,-607
"280","2013-04",0.0451746484325196,241.824940005813,397.246023387635,184,38,-146
"281","2013-05",0.0452078569366869,325.639798538691,200.097649175312,70,117,47
"282","2013-06",0.0452271879399294,532.379555297177,103.308298035916,0,317,317
"283","2013-07",0.0452479950117468,691.590038786031,122.624030578628,0,402,402
"284","2013-08",0.0452625517522537,550.60726927779,110.691901621855,0,319,319
"285","2013-09",0.0452706967855367,406.922085301643,125.240794329314,14,179,165
"286","2013-10",0.0452793677650758,240.860201934674,256.260558327944,160,40,-120
"287","2013-11",0.0452875975711713,211.828906993575,1038.75777177258,498,3,-495
"288","2013-12",0.0453036625861398,335.151391257567,1330.24375066602,586,5,-581
"289","2014-01",0.0453165684621381,334.082145747207,2074.4182735173,891,0,-891
"290","2014-02",0.0453446808143314,244.55494746249,1304.19917698729,597,0,-597
"291","2014-03",0.045385313979938,239.850986579479,1212.09732557205,578,0,-578
"292","2014-04",0.0454335348507903,235.081028699339,356.109795258489,156,17,-139
"293","2014-05",0.0454877826513242,320.814009773451,143.558942520371,30,179,149
"294","2014-06",0.0455507320245818,508.822045868355,101.5014299167,0,345,345
"295","2014-07",0.0456227645372343,645.570265610481,121.618452184317,0,373,373
"296","2014-08",0.045695029905712,546.832229483236,105.548932420848,0,324,324
"297","2014-09",0.0457781509952701,456.217836453118,122.782199656472,10,223,213
"298","2014-10",0.0458721143528095,293.903384375761,220.529201895574,126,45,-81
"299","2014-11",0.0459793973163904,201.124383029254,1051.76411018548,549,0,-549
"300","2014-12",0.046102619400767,288.187934737709,1355.2603873658,605,0,-605
"301","2015-01",0.0462374695019663,355.735917667665,1669.98152771452,766,0,-766
"302","2015-02",0.0463660077986216,226.321288084678,1873.98513599512,815,0,-815
"303","2015-03",0.0464744039803944,247.531510645313,796.742101637861,400,2,-398
"304","2015-04",0.046562770983359,239.257165252667,303.277267432733,153,36,-117
"305","2015-05",0.0466332080053665,290.755324662837,140.853249808288,19,185,166
"306","2015-06",0.0466863321866112,524.54143834399,120.827280781005,1,399,398
"307","2015-07",0.0467190770940258,601.172196070683,109.209146299593,0,453,453
"308","2015-08",0.0467317687754382,571.494866193166,130.352901717983,0,364,364
"309","2015-09",0.0467282679965918,495.967545115541,117.126046254784,8,225,217
"310","2015-10",0.046706990259583,339.213124430258,293.232018144146,161,13,-148
"311","2015-11",0.0466788265944416,214.557743380545,660.290200201482,314,8,-306
"312","2015-12",0.0466311097207288,316.003592377063,730.91208120603,324,15,-309
"313","2016-01",0.0465798924543146,360.795992701434,1729.98384235673,812,0,-812
"314","2016-02",0.0465427952539515,251.061198641187,1378.91630939816,627,0,-627
"315","2016-03",0.0465158104109637,252.029384307871,547.4970648829,277,16,-261
"316","2016-04",0.0464996628042966,229.945793270064,351.885747149249,191,33,-158
"317","2016-05",0.0464943767790098,295.410936845956,176.417440234051,57,109,52
"318","2016-06",0.0465010407276211,578.654895314782,129.979671650224,0,334,334
"319","2016-07",0.0465155018626579,615.561093279179,111.247057680696,0,484,484
"320","2016-08",0.0465419399760484,656.866094544262,110.914314121605,0,481,481
"321","2016-09",0.0465803532666439,421.122267303869,115.351137025886,0,351,351
"322","2016-10",0.0466290804614355,251.64067083776,182.040366492909,68,100,32
"323","2016-11",0.0466976684242939,256.166019866444,667.130927487616,383,5,-378
"324","2016-12",0.046782517284425,328.624829285534,1365.58266887428,652,0,-652
"325","2017-01",0.0468771958956752,323.419077324363,1261.18069496024,595,0,-595
"326","2017-02",0.0469710941123612,245.096330233331,752.196759227333,385,0,-385
"327","2017-03",0.0470508936993984,269.394162998467,860.823007075625,451,4,-447
"328","2017-04",0.0471180097157036,256.116404344144,243.236553291418,99,76,-23
"329","2017-05",0.0471696439563836,341.132885359192,159.347192942496,44,141,97
"330","2017-06",0.0472082643278943,535.668529926636,109.253825559529,1,274,273
"331","2017-07",0.0472308745078762,701.235069382597,119.228653314795,0,443,443
"332","2017-08",0.0472394070316816,596.918682580504,104.202059814475,0,347,347
"333","2017-09",0.0472364357978789,423.32635384957,114.889894606524,13,194,181
"334","2017-10",0.0472221408829852,278.643297691641,220.953667656758,141,80,-61
"335","2017-11",0.0472016499147307,245.578175611876,841.043349312551,446,2,-444
"336","2017-12",0.0471736199736535,310.671308247323,1511.5403749264,696,0,-696
