"","Date","Real GDP per capita (millions of chained 2012 dollars per person)","Electricity Sale to Residential Consumers per capita (MJ/person)","Natural Gas Deliveries to Residential Consumers per capita (MJ/person)","HDD","CDD","DD"
"1","1990-01",0.0291366758200154,2470.85828856157,1348.2690418159,783,0,-783
"2","1990-02",0.0291069208013887,2499.35100647247,1444.93876745693,792,0,-792
"3","1990-03",0.0290776705676329,2350.65466321813,1206.8075829596,614,0,-614
"4","1990-04",0.0290315398755819,1894.96713181357,747.929729838315,408,0,-408
"5","1990-05",0.0289966050873424,1563.45738094748,579.929011803847,330,0,-330
"6","1990-06",0.0289615495349621,1392.19339664647,437.190918705489,168,20,-148
"7","1990-07",0.0289306475811831,1300.2558145245,235.55516937583,31,112,81
"8","1990-08",0.0289011872977721,1228.04479665978,177.983519562607,34,85,51
"9","1990-09",0.0288750721217799,1178.30277953819,210.231605259802,95,18,-77
"10","1990-10",0.0288542560991067,1331.33240232204,438.332618257658,494,0,-494
"11","1990-11",0.0288500530932913,1636.47212288555,878.367367110926,623,0,-623
"12","1990-12",0.0288516706329169,2335.79652279654,1365.50740367716,1053,0,-1053
"13","1991-01",0.0288613913173638,2847.36781626776,1889.55606424575,934,0,-934
"14","1991-02",0.0288690080869184,2644.3817526221,1384.79092147596,559,0,-559
"15","1991-03",0.0288836508203086,2272.6259504294,1229.51351485425,705,0,-705
"16","1991-04",0.0288945700487865,1994.99442670321,1040.84533542373,491,0,-491
"17","1991-05",0.0288989457556316,1653.86519268577,680.716731120275,344,0,-344
"18","1991-06",0.0288962654974749,1413.70031986909,503.565793471491,218,1,-217
"19","1991-07",0.0289156199812546,1268.90601720755,283.268185068197,40,64,24
"20","1991-08",0.0289340322895529,1190.51476817607,208.248132850163,38,91,53
"21","1991-09",0.0289549421717417,1177.63147954852,241.147508181673,124,13,-111
"22","1991-10",0.0289826506246754,1282.10377928437,373.634177575233,460,0,-460
"23","1991-11",0.0290200327086777,1655.85570196289,956.671218613441,636,0,-636
"24","1991-12",0.0290690451729874,2092.23957671047,1374.1026893303,763,0,-763
"25","1992-01",0.0291225193771343,2430.47006716702,1577.1806670622,752,0,-752
"26","1992-02",0.0291721414320445,2312.8058149874,1289.16227653248,595,0,-595
"27","1992-03",0.029212360216196,2043.52175679112,1017.81047540163,512,0,-512
"28","1992-04",0.0292397764517616,1727.66237101018,804.129641483427,397,0,-397
"29","1992-05",0.0292606646581634,1451.35462266124,510.567419927281,215,8,-207
"30","1992-06",0.0292732359261696,1247.63911155684,296.647040034696,86,67,-19
"31","1992-07",0.0292798540811372,1204.5359249449,194.641350672094,42,58,16
"32","1992-08",0.0292746556739187,1191.49014870374,204.015695777434,51,82,31
"33","1992-09",0.0292673860864111,1176.02140983784,278.968438779864,212,3,-209
"34","1992-10",0.0292556853521312,1268.08375881301,475.186599449808,392,0,-392
"35","1992-11",0.029243295026133,1616.5947003841,898.550487219627,668,0,-668
"36","1992-12",0.0292296584992753,2267.45986377208,1679.30937269617,949,0,-949
"37","1993-01",0.0292101503241618,2748.63720313763,2046.49921238705,1028,0,-1028
"38","1993-02",0.0292066883601917,2564.8326724203,1547.63259082921,787,0,-787
"39","1993-03",0.02921492331344,2279.09587024365,1405.91654273994,625,0,-625
"40","1993-04",0.0292292390876769,1919.37352441677,981.94590450376,462,0,-462
"41","1993-05",0.0292534574723398,1602.1592499442,656.364988268314,181,11,-170
"42","1993-06",0.0292855029908686,1335.72661887145,549.562055309625,151,6,-145
"43","1993-07",0.0293267824417869,1206.9244067058,298.325919896318,116,5,-111
"44","1993-08",0.0293753216565692,1174.01159085772,259.965297912469,68,56,-12
"45","1993-09",0.0294366123283902,1185.40519498443,287.323649956898,175,20,-155
"46","1993-10",0.0295094085048183,1334.84067980574,452.218880576993,367,0,-367
"47","1993-11",0.0295992413318489,1669.5758327317,968.249794018092,815,0,-815
"48","1993-12",0.0297023058101413,2219.2106376425,1728.15061425865,839,0,-839
"49","1994-01",0.0298165507095269,2387.38260848608,1642.31398211407,718,0,-718
"50","1994-02",0.0299155247543982,2254.3648680929,1622.17963561156,775,0,-775
"51","1994-03",0.029987124164267,2184.24350898544,1383.02039000902,582,0,-582
"52","1994-04",0.0300263285221706,1808.4366944543,935.668469531917,401,0,-401
"53","1994-05",0.0300492441063388,1470.73750826906,547.584024877997,254,4,-250
"54","1994-06",0.0300442386113469,1283.26193704858,404.714501536011,173,11,-162
"55","1994-07",0.0300150775886463,1208.57083704075,300.999170245412,34,102,68
"56","1994-08",0.0299621245446471,1144.21543645503,214.056820116858,22,56,34
"57","1994-09",0.029885839972937,1128.07508144026,259.50807468587,89,12,-77
"58","1994-10",0.0297892083703768,1290.76795435337,524.698763256426,454,0,-454
"59","1994-11",0.0296753346092236,1658.2361739964,1263.80819487195,770,0,-770
"60","1994-12",0.0295417475350737,2217.02700035205,1867.95871435364,840,0,-840
"61","1995-01",0.0293873426728732,2492.73336128477,1841.20231809847,793,0,-793
"62","1995-02",0.0292763595846301,2242.20784987928,1432.88463135864,640,0,-640
"63","1995-03",0.029206847471148,2084.57612198219,1400.42407116757,631,0,-631
"64","1995-04",0.0291717736363918,1841.33881502295,1029.52436359177,471,0,-471
"65","1995-05",0.0291804913851541,1520.7280692591,626.952987814165,227,3,-224
"66","1995-06",0.0292246974511701,1329.55631584098,390.460270096177,134,25,-109
"67","1995-07",0.0293066041041428,1208.88040946491,275.50232391629,31,75,44
"68","1995-08",0.0294284894176966,1153.12820488367,252.86636203983,106,22,-84
"69","1995-09",0.0295867642488791,1144.69996623945,284.77179280778,90,18,-72
"70","1995-10",0.0297855141728188,1328.43428414196,492.537837317992,457,0,-457
"71","1995-11",0.0300321041459468,1615.68401066294,1143.99740885807,568,0,-568
"72","1995-12",0.0303240162669335,2036.51153489768,1530.73855560872,823,0,-823
"73","1996-01",0.0306592980791062,2377.73035843338,1810.99810585783,898,0,-898
"74","1996-02",0.030920252094865,2437.61740571942,2040.74189697025,770,0,-770
"75","1996-03",0.0311038325175704,2341.59244453793,1533.25241426487,632,0,-632
"76","1996-04",0.0312087728460291,1797.84431956933,1085.82028643149,431,0,-431
"77","1996-05",0.0312412086810036,1634.86159345655,892.018432825297,399,0,-399
"78","1996-06",0.0311964318056118,1400.03504754194,521.803859302495,166,6,-160
"79","1996-07",0.0310777607954063,1259.78534829901,325.034840046501,55,110,55
"80","1996-08",0.0308815188962941,1184.49210006794,249.177428393496,48,68,20
"81","1996-09",0.0306130447876828,1190.16986244075,312.865871433818,233,2,-231
"82","1996-10",0.0302750152904378,1326.52793157341,582.233375031259,472,0,-472
"83","1996-11",0.0298657917347828,1676.38853807829,1231.46997601216,738,0,-738
"84","1996-12",0.0293942637774496,2300.01994150438,1942.55217625722,939,0,-939
"85","1997-01",0.0288537553282046,2582.93874099161,1728.52331985418,865,0,-865
"86","1997-02",0.0285773361732764,2444.48609633221,1487.28104802365,704,0,-704
"87","1997-03",0.0285600144196215,2171.8024470951,1288.18579695658,660,0,-660
"88","1997-04",0.0287983474382441,1866.44675324596,725.367246910205,498,0,-498
"89","1997-05",0.0292965944760366,1491.31567963191,883.201824236453,216,4,-212
"90","1997-06",0.0300493719614766,1291.37816268906,481.718330207908,159,5,-154
"91","1997-07",0.03105697554976,1216.3646562778,391.484766580163,49,41,-8
"92","1997-08",0.0323131305570556,1160.10849697025,350.832565011335,15,102,87
"93","1997-09",0.0338246532242371,1152.53466459041,391.494758312372,111,14,-97
"94","1997-10",0.035592078438316,1347.89087774617,707.346654537299,450,0,-450
"95","1997-11",0.0376171302876056,1576.19402260413,1480.50198682834,587,0,-587
"96","1997-12",0.0398997809186431,2110.98162233932,2220.65510440038,823,0,-823
"97","1998-01",0.0424314828397553,2393.23483377248,2287.16806617741,813,0,-813
"98","1998-02",0.0447385452643264,2178.00252970633,1886.48309251116,606,0,-606
"99","1998-03",0.0468137596543757,1998.09323291352,1737.12424077035,593,0,-593
"100","1998-04",0.0486433547623391,1750.55903940233,1129.75465008342,457,1,-456
"101","1998-05",0.0502401897894454,1501.33541657699,623.860804297906,289,2,-287
"102","1998-06",0.0516029724075659,1319.07534603055,447.352527376821,127,9,-118
"103","1998-07",0.0527331232784061,1272.25558206371,341.18071034627,19,134,115
"104","1998-08",0.0536273526038974,1156.08535306432,303.949792842895,28,89,61
"105","1998-09",0.0542956716275786,1192.93135357479,321.621569638574,106,34,-72
"106","1998-10",0.0547383744183534,1367.45379933289,467.888380969957,435,0,-435
"107","1998-11",0.0549592449395946,1638.90596736992,911.513803248863,596,0,-596
"108","1998-12",0.0549619794886643,2090.80068513296,1538.65212621422,877,0,-877
"109","1999-01",0.054734011515461,2424.09691636837,2339.35372648008,777,0,-777
"110","1999-02",0.0545427423473647,2294.57881773445,1923.20856937925,680,0,-680
"111","1999-03",0.0543675100511079,2181.49636436948,1724.47085774862,669,0,-669
"112","1999-04",0.0541951090616749,1836.9800508434,1317.99873994866,516,0,-516
"113","1999-05",0.0540367345546843,1619.13851434314,893.263281657582,399,2,-397
"114","1999-06",0.0538904634227396,1391.05528379614,586.171321728341,204,19,-185
"115","1999-07",0.0537591081871324,1247.09292879811,374.480222843675,83,35,-48
"116","1999-08",0.0536413426699559,1225.64863334626,333.959829484891,34,67,33
"117","1999-09",0.0535426495700916,1241.58210319043,371.802650558868,176,3,-173
"118","1999-10",0.0534628795585209,1362.15538734078,764.075686559841,461,0,-461
"119","1999-11",0.0534100931357541,1671.77121877489,1249.13209250052,573,0,-573
"120","1999-12",0.053381540194454,2040.78422549919,1840.43071335275,782,0,-782
"121","2000-01",0.0533662588963852,2404.39006342454,2145.15616256338,872,0,-872
"122","2000-02",0.0533439316932455,2222.65932323416,1947.32349679006,702,0,-702
"123","2000-03",0.0532992516301934,2059.50019213653,1722.86565490258,654,0,-654
"124","2000-04",0.0532209654910709,1674.74915345274,1227.47923417893,420,0,-420
"125","2000-05",0.0531347439334296,1481.03608967982,854.760939816234,316,0,-316
"126","2000-06",0.0530214100408849,1319.14316851432,580.565929939053,146,27,-119
"127","2000-07",0.0528789757817723,1241.02759493322,370.992831158531,62,54,-8
"128","2000-08",0.0527207760223252,1258.48203559899,299.33717619072,75,41,-34
"129","2000-09",0.0525391806367083,1197.48108323664,374.608660254631,186,9,-177
"130","2000-10",0.0523392755977263,1325.71848254285,598.058248216959,441,0,-441
"131","2000-11",0.0521264291301094,1724.96578521889,1255.50933711617,763,0,-763
"132","2000-12",0.0518928984316347,2227.74358126229,2009.6279418971,886,0,-886
"133","2001-01",0.0516477313991923,2395.55207575361,2045.39617366311,824,0,-824
"134","2001-02",0.0514347270431075,2148.39223892131,2025.31795088823,759,0,-759
"135","2001-03",0.0512468261551211,1952.20257589603,1637.51130030034,641,0,-641
"136","2001-04",0.051082257368245,1719.82699873747,1340.76015805884,521,0,-521
"137","2001-05",0.050946946845206,1468.86639281728,901.922414028219,304,8,-296
"138","2001-06",0.0508331694649031,1241.8147294265,556.309886898701,209,6,-203
"139","2001-07",0.0507475935063456,1154.89466802179,368.939563937897,85,41,-44
"140","2001-08",0.0506858483638695,1120.2767142395,303.946379748061,49,67,18
"141","2001-09",0.0506481341732358,1083.87851531399,326.324057381862,156,11,-145
"142","2001-10",0.0506584075838911,1256.91585042598,1042.65341938478,467,0,-467
"143","2001-11",0.0506864833561794,1506.69795905451,2039.37300124931,600,0,-600
"144","2001-12",0.050745921133715,1961.88880502359,2921.10689444059,836,0,-836
"145","2002-01",0.0508373055594483,2216.8072329527,1996.19497988911,816,0,-816
"146","2002-02",0.0509254298922526,2132.02156134386,2048.4687540369,706,0,-706
"147","2002-03",0.051016512620741,2087.43815166676,1872.17100315177,771,0,-771
"148","2002-04",0.0510975531419691,1737.80195674858,1435.16804793055,502,0,-502
"149","2002-05",0.0511711306458452,1485.96823468774,1007.27819892939,366,0,-366
"150","2002-06",0.0512362597503895,1249.30425608345,549.822532278726,552,19,-533
"151","2002-07",0.0513012380223247,1198.69795553181,341.559993060094,59,89,30
"152","2002-08",0.0513594538392246,1125.95296170487,287.883823844983,57,55,-2
"153","2002-09",0.0514108353227977,1127.95580735339,323.279193644478,172,8,-164
"154","2002-10",0.0514620643063727,1252.69934708044,571.70812398837,488,0,-488
"155","2002-11",0.0515152382293069,1554.38507616232,1241.0326888822,621,0,-621
"156","2002-12",0.0515758388012191,1901.20231181052,1663.81909707395,767,0,-767
"157","2003-01",0.0516334777005258,2041.80856466232,1873.14120218356,708,0,-708
"158","2003-02",0.0516982585290602,1923.86434128383,1730.27380673145,694,0,-694
"159","2003-03",0.0517558423403816,1914.25762759371,1692.06085283397,592,0,-592
"160","2003-04",0.0517997426936951,1725.52418766536,1274.46944787037,481,0,-481
"161","2003-05",0.0518306253918547,1425.9296439858,920.438833064035,322,4,-318
"162","2003-06",0.0518217696668488,1288.16000280664,526.034248982297,111,47,-64
"163","2003-07",0.0517970790855087,1239.6945900124,341.794156944515,28,111,83
"164","2003-08",0.0517644477956407,1144.83247086792,277.913145564591,20,61,41
"165","2003-09",0.0517277181846035,1141.90704300554,330.017703477148,129,32,-97
"166","2003-10",0.0516832336339482,1246.90118436129,520.63361565877,342,0,-342
"167","2003-11",0.0516338578620687,1579.53678905558,1358.09537999122,773,0,-773
"168","2003-12",0.0515861586976515,2100.05243869508,1958.39100101847,824,0,-824
"169","2004-01",0.0515334249166422,2330.5804986117,2379.07233924791,887,0,-887
"170","2004-02",0.0515238820726448,1985.20494148121,1851.63895320332,689,0,-689
"171","2004-03",0.0515484810333435,1992.75287786538,1495.09972880764,555,0,-555
"172","2004-04",0.0515959177970121,1584.38752579873,1003.59788257241,378,0,-378
"173","2004-05",0.051673610991585,1289.55333119369,632.939230276096,262,0,-262
"174","2004-06",0.0517927082558791,1251.77318104203,505.935237791325,114,40,-74
"175","2004-07",0.0519443574659077,1218.50285536018,330.784254587778,29,123,94
"176","2004-08",0.0521266545334508,1229.63858258364,283.879562148008,18,102,84
"177","2004-09",0.0523447352707234,1175.25573673309,359.171362602498,191,2,-189
"178","2004-10",0.0525947982688356,1273.36600815836,619.335179877208,395,0,-395
"179","2004-11",0.0528902431379463,1574.33854862903,1333.69427580714,660,0,-660
"180","2004-12",0.0532250288314964,1994.24078894288,1834.2341749372,1023,0,-1023
"181","2005-01",0.0535947111833061,2270.5458205407,2211.43658328714,838,0,-838
"182","2005-02",0.0539497230021176,2006.98954177886,1753.09626354734,700,0,-700
"183","2005-03",0.0542636969469022,1913.52814658134,1459.8942893506,551,0,-551
"184","2005-04",0.0545312216028292,1646.22231305232,1250.20200170429,444,0,-444
"185","2005-05",0.0547596945993461,1368.39136200044,650.397004892906,228,12,-216
"186","2005-06",0.0549593873041368,1258.95753366107,506.553047221644,169,9,-160
"187","2005-07",0.0551198148018634,1212.9871944704,354.035893503181,39,64,25
"188","2005-08",0.0552470257379972,1244.18009633814,295.267158268313,25,72,47
"189","2005-09",0.0553377039725513,1158.39898071123,361.353295526791,210,1,-209
"190","2005-10",0.0553962872511283,1285.9689867849,634.947413325938,382,0,-382
"191","2005-11",0.0554392771225397,1583.45937549907,1301.97099960285,723,0,-723
"192","2005-12",0.0554384934894129,2152.39985442541,2165.1310426353,884,0,-884
"193","2006-01",0.055411951629087,2199.09948215404,1812.46944552744,729,0,-729
"194","2006-02",0.0554142987813964,2000.40480420988,1961.24765629497,748,0,-748
"195","2006-03",0.0554550446946296,2067.40612621095,1798.49732536555,690,0,-690
"196","2006-04",0.0555197278912537,1631.97813596868,1171.58993852039,504,0,-504
"197","2006-05",0.0556166413912702,1412.64814081153,745.375888585777,338,8,-330
"198","2006-06",0.0557354775602736,1316.58234317102,457.31172458591,165,24,-141
"199","2006-07",0.055880644774861,1332.95091206292,325.524794324582,74,100,26
"200","2006-08",0.056058897905071,1336.03523458068,296.479836697333,83,43,-40
"201","2006-09",0.056259240232569,1207.86121204948,367.435847982694,159,17,-142
"202","2006-10",0.056496781278653,1310.92979491833,666.590789349159,480,0,-480
"203","2006-11",0.0567685482977787,1588.20002274097,1379.71468206305,715,0,-715
"204","2006-12",0.0570622511783818,2061.52702776738,2064.30718558208,865,0,-865
"205","2007-01",0.057394230341365,2412.50685560799,2330.18159562,934,0,-934
"206","2007-02",0.0577034528384454,2130.54559412723,1977.73298388161,678,0,-678
"207","2007-03",0.0579857394424943,1928.09434085045,1567.00948134978,615,0,-615
"208","2007-04",0.0582286833942162,1611.96749280482,1155.93443203052,521,0,-521
"209","2007-05",0.0584431122866189,1450.33733971468,798.766261697267,346,1,-345
"210","2007-06",0.0586203011639507,1275.29615500905,498.322650185191,227,11,-216
"211","2007-07",0.0587604468603923,1345.59845502003,345.219605105514,46,89,43
"212","2007-08",0.0588685764210527,1319.03077213379,314.332952921418,94,31,-63
"213","2007-09",0.0589458399856436,1184.94441147312,376.329599467103,240,5,-235
"214","2007-10",0.0589983994414369,1350.08376362171,800.788112987885,514,0,-514
"215","2007-11",0.0590191145227774,1598.09146720081,1411.34777043677,718,0,-718
"216","2007-12",0.0590144071870326,2107.31915695765,2073.86290656649,883,0,-883
"217","2008-01",0.0589875134584557,2362.55234764867,2252.53069183388,954,0,-954
"218","2008-02",0.0589382558213289,2233.05384209559,2179.68977758433,719,0,-719
"219","2008-03",0.0588620361288864,1989.63200932673,1677.47108767797,742,0,-742
"220","2008-04",0.0587673767333321,1764.11410796891,1518.49473807454,622,0,-622
"221","2008-05",0.0586368375937031,1533.23507958576,997.544122237573,338,7,-331
"222","2008-06",0.0584831178653766,1342.4805261604,635.476264292088,274,20,-254
"223","2008-07",0.058299991064141,1349.59466716948,394.752848288044,89,37,-52
"224","2008-08",0.0580876814443098,1288.63230878252,329.446825233698,100,64,-36
"225","2008-09",0.0578531846390698,1210.67205837231,372.718062507159,187,4,-183
"226","2008-10",0.057597992757438,1302.15730167261,701.870001617396,494,0,-494
"227","2008-11",0.0573213075909471,1485.9664668787,1180.01701949058,598,0,-598
"228","2008-12",0.0570290889173109,2071.81330486867,1938.19289724804,1001,0,-1001
"229","2009-01",0.0567083747990346,2418.30870601955,2401.11673693993,900,0,-900
"230","2009-02",0.0564363061852471,2174.45508559547,2036.52003714593,756,0,-756
"231","2009-03",0.0562024586707265,2074.34910767576,1855.3550609926,793,0,-793
"232","2009-04",0.0560132966544562,1740.69824793076,1327.43543493335,543,0,-543
"233","2009-05",0.0558602944074442,1441.78629291798,809.512647077061,355,4,-351
"234","2009-06",0.0557453022338727,1276.53966846355,430.820657266545,146,14,-132
"235","2009-07",0.0556678855722684,1307.13960051192,319.12099020751,53,117,64
"236","2009-08",0.0556295548210128,1270.20572629627,282.998360787223,81,68,-13
"237","2009-09",0.0556246959116471,1199.31392781836,330.233567339009,156,16,-140
"238","2009-10",0.0556629030576126,1301.41131949699,715.474080450123,519,0,-519
"239","2009-11",0.0557441780849227,1541.05777540745,1280.15583337316,665,0,-665
"240","2009-12",0.0558768540380564,2126.80423724602,2116.92040535757,1002,0,-1002
"241","2010-01",0.056044374771374,2232.8458426333,1806.97551934825,706,0,-706
"242","2010-02",0.0561962502617307,1839.78094609294,1423.35259225659,622,0,-622
"243","2010-03",0.0563340250002838,1797.9675967574,1301.41171826198,634,0,-634
"244","2010-04",0.0564529766616632,1566.98249247502,1123.66164519335,540,0,-540
"245","2010-05",0.0565541547858437,1390.41805549325,813.114207117978,441,0,-441
"246","2010-06",0.0566385920873715,1289.18702314569,553.387562803277,258,4,-254
"247","2010-07",0.0566997159725316,1287.37149384652,355.739247336771,106,57,-49
"248","2010-08",0.0567384088459743,1303.76561061478,314.124585622398,107,64,-43
"249","2010-09",0.0567554380874152,1180.4281428625,326.630896764717,195,1,-194
"250","2010-10",0.056754891410395,1202.22086829872,796.605526260408,434,0,-434
"251","2010-11",0.0567476390885894,1481.2661575068,1628.69075826431,759,0,-759
"252","2010-12",0.0567253896880844,2073.3114703948,1888.95960492655,826,0,-826
"253","2011-01",0.0566809309806365,2215.12633179762,2043.92033950214,856,0,-856
"254","2011-02",0.056663760926823,1984.4613269609,1887.2631476242,812,0,-812
"255","2011-03",0.0566684341837592,2048.4414098594,1606.87715776106,708,0,-708
"256","2011-04",0.0566802104555779,1679.94743167156,1314.57672405456,652,0,-652
"257","2011-05",0.0567101709497473,1477.28594614141,806.811642679574,456,0,-456
"258","2011-06",0.0567593169833529,1297.91127011217,450.771902846548,254,2,-252
"259","2011-07",0.0568155588485599,1247.16341298763,332.737560365444,135,13,-122
"260","2011-08",0.0568884940770838,1286.11213753139,319.836840739219,71,45,-26
"261","2011-09",0.0569718174329852,1173.4381388037,324.152451669575,130,34,-96
"262","2011-10",0.0570785057891951,1198.41532542388,869.89095775586,484,0,-484
"263","2011-11",0.057208032997604,1557.52373173771,1721.4298249275,763,0,-763
"264","2011-12",0.0573542381785865,2044.85603027637,2104.91230650772,904,0,-904
"265","2012-01",0.0575156028423163,2140.98849023732,2084.50944173539,891,0,-891
"266","2012-02",0.0576803689020008,2033.01301270377,1804.32716388476,738,0,-738
"267","2012-03",0.0578252852136532,1918.31676128467,1707.77779878717,752,0,-752
"268","2012-04",0.0579617941417304,1578.5100917054,924.863308311639,503,0,-503
"269","2012-05",0.0580896153725403,1346.97793151396,641.288330121431,385,1,-384
"270","2012-06",0.0582000902324741,1252.625109413,476.003272236409,280,3,-277
"271","2012-07",0.0582973965205462,1313.45208046061,326.468149906452,90,47,-43
"272","2012-08",0.0583780982039393,1295.42840864367,308.27576127898,57,84,27
"273","2012-09",0.0584437123997304,1122.65890693135,347.445270186178,149,5,-144
"274","2012-10",0.0585038230491421,1206.3555353725,823.566228907818,451,0,-451
"275","2012-11",0.0585584063851084,1462.10021534709,1384.99224460934,649,0,-649
"276","2012-12",0.0586078002879697,1887.74187538678,1931.86015103078,840,0,-840
"277","2013-01",0.0586504961982617,2236.64432689609,2312.37284795647,932,0,-932
"278","2013-02",0.058710893674709,1972.40366794205,1628.66494946942,699,0,-699
"279","2013-03",0.0587735660525641,1805.11588901052,1449.18646681493,645,0,-645
"280","2013-04",0.0588374863860758,1596.56656756083,1051.41075307162,515,0,-515
"281","2013-05",0.0589134938932165,1338.64721090631,587.691830379961,303,4,-299
"282","2013-06",0.0589811710131037,1151.38992791188,380.1331839686,168,22,-146
"283","2013-07",0.0590591309243828,1281.97675013388,272.989652478132,48,69,21
"284","2013-08",0.0591379462307968,1229.71429036057,301.749662808375,7,85,78
"285","2013-09",0.0592173715106903,1151.36667890493,348.229008139076,149,30,-119
"286","2013-10",0.0593058145565469,1273.05094021375,1037.40645068403,487,0,-487
"287","2013-11",0.05940206644818,1488.79587555326,1537.44953390429,707,0,-707
"288","2013-12",0.0595162178312026,2082.13226231573,2266.72139589187,967,0,-967
"289","2014-01",0.0596348170653782,2194.23484607316,2025.9549728688,801,0,-801
"290","2014-02",0.059762417824016,2019.43463555042,1986.89654764933,829,0,-829
"291","2014-03",0.0598957444327957,1845.26152484069,1396.81214698401,657,0,-657
"292","2014-04",0.0600287412103033,1483.79522427063,915.072854954215,480,0,-480
"293","2014-05",0.060159479455205,1262.24178400002,530.372286040378,284,0,-284
"294","2014-06",0.0602912410598096,1157.62941703561,368.834568354117,183,1,-182
"295","2014-07",0.0604244962738419,1223.54383305978,299.112381889946,39,110,71
"296","2014-08",0.0605483555560661,1226.1490346616,268.46904376887,25,90,65
"297","2014-09",0.0606758992182246,1131.45130308189,325.251233646862,117,10,-107
"298","2014-10",0.0608071217812176,1158.43871690439,573.595813567518,320,0,-320
"299","2014-11",0.0609450801743261,1341.29764471121,1782.68781428964,710,0,-710
"300","2014-12",0.0610929972054051,1887.06125378189,1827.38770576139,792,0,-792
"301","2015-01",0.0612455689409631,1958.35751465061,1825.05722225523,759,0,-759
"302","2015-02",0.0614023331212339,1597.616555437,1250.28814501853,570,0,-570
"303","2015-03",0.0615462779831615,1583.30150359472,1116.87178998148,544,0,-544
"304","2015-04",0.061677522941257,1409.25552960027,921.8946729469,513,0,-513
"305","2015-05",0.0617986170484763,1175.02762551519,478.474290941864,260,3,-257
"306","2015-06",0.0619102873564076,1180.82516276756,294.740816175123,79,72,-7
"307","2015-07",0.0620087390156414,1291.58433858512,261.409319780129,27,127,100
"308","2015-08",0.0620943314785737,1225.82330751485,251.332965610525,39,78,39
"309","2015-09",0.0621717626392654,1147.738249757,400.549738909173,237,6,-231
"310","2015-10",0.0622390448579839,1168.43611184777,642.617862753297,335,0,-335
"311","2015-11",0.06230954667231,1468.1039993722,1713.96308993909,753,0,-753
"312","2015-12",0.0623676514222362,1945.09918456607,1902.43206197803,851,0,-851
"313","2016-01",0.0624331366550844,1979.03832629166,1968.71458957692,837,0,-837
"314","2016-02",0.0625146438547889,1667.32577066936,1410.83628795997,629,0,-629
"315","2016-03",0.0626071867482629,1601.68443611805,1352.78695188082,614,0,-614
"316","2016-04",0.0627116230308717,1232.49791038397,629.818428829687,358,0,-358
"317","2016-05",0.0628279459177405,1114.18121252885,480.2548516475,267,0,-267
"318","2016-06",0.062957473735322,1125.16140591923,347.920595259868,176,32,-144
"319","2016-07",0.0630950020294776,1197.21430988222,280.150021866538,72,41,-31
"320","2016-08",0.0632456965800022,1230.44236356256,267.77810292225,35,93,58
"321","2016-09",0.0634095270678097,1073.65993904131,383.989344497101,161,0,-161
"322","2016-10",0.0635843883950516,1232.95948039625,834.130519541404,410,0,-410
"323","2016-11",0.063782198097856,1372.18869816812,1176.98007281078,545,0,-545
"324","2016-12",0.0639984483442935,2092.24710151529,2400.87979152219,1015,0,-1015
"325","2017-01",0.0642250599698534,2254.58566125102,2519.29833262142,1030,0,-1030
"326","2017-02",0.0644415252966901,1839.09770714078,1860.13977490066,799,0,-799
"327","2017-03",0.0646312438639325,1807.43888352306,1555.37137825291,694,0,-694
"328","2017-04",0.064796075223753,1397.68620614081,1048.05190874225,537,0,-537
"329","2017-05",0.0649325756320015,1248.75662513846,602.096013317044,309,5,-304
"330","2017-06",0.0650439127361291,1133.97373144801,330.857032889259,176,18,-158
"331","2017-07",0.0651263722433784,1205.06687734523,267.507349749934,50,59,9
"332","2017-08",0.0651824344829316,1237.06525215969,259.324016368629,27,114,87
"333","2017-09",0.0652153858873527,1086.19057473149,361.509898148208,162,43,-119
"334","2017-10",0.065225491820287,1236.22571537655,956.272862784839,495,0,-495
"335","2017-11",0.0652192513760245,1467.45981272741,1564.03899551392,693,0,-693
"336","2017-12",0.0651949973922202,1919.85442700994,2209.38006950334,928,0,-928
