"","Date","Real GDP per capita (millions of chained 2012 dollars per person)","Electricity Sale to Residential Consumers per capita (MJ/person)","Natural Gas Deliveries to Residential Consumers per capita (MJ/person)","HDD","CDD","DD"
"1","1990-01",0.0300604152602496,1559.96623603768,4468.22144973674,1184,0,-1184
"2","1990-02",0.030048573017074,1422.00769409292,4123.72960390622,1120,0,-1120
"3","1990-03",0.0300461566183609,1306.46001716224,3679.78938850125,963,0,-963
"4","1990-04",0.0300429704592358,1119.8168016419,2773.14817964086,638,0,-638
"5","1990-05",0.0300553744600589,1019.70617710161,2063.30582087645,487,0,-487
"6","1990-06",0.0300767257729078,945.783341861999,1420.30574373586,146,69,-77
"7","1990-07",0.0301095077905731,853.713048041988,776.18400828572,38,103,65
"8","1990-08",0.0301521010837605,894.793802502346,697.897490350378,34,76,42
"9","1990-09",0.0302056084230801,831.709801052578,619.777127203815,149,37,-112
"10","1990-10",0.0302711818748348,970.822039786611,1170.75557810332,631,0,-631
"11","1990-11",0.0303556055077134,1136.99313410925,2352.25895518921,890,0,-890
"12","1990-12",0.0304524805634466,1597.87534190253,3759.82277553218,1561,0,-1561
"13","1991-01",0.0305632088680969,1814.8510306852,5405.76596178043,1449,0,-1449
"14","1991-02",0.0306584010666614,1426.83427128629,4026.78938405399,912,0,-912
"15","1991-03",0.030743591385827,1335.80988126588,3233.24302058545,938,0,-938
"16","1991-04",0.0308122562442084,1182.51436127411,2710.08743838644,740,0,-740
"17","1991-05",0.030862658484816,1059.58667144197,2220.85362535853,432,0,-432
"18","1991-06",0.030894475908939,940.84497153364,1113.84868623578,119,21,-98
"19","1991-07",0.0309256086511749,950.426101530595,704.213666965975,30,109,79
"20","1991-08",0.0309420161891817,946.301783112895,621.821606556933,17,110,93
"21","1991-09",0.0309458612973368,907.376383118623,657.072665049,269,17,-252
"22","1991-10",0.0309398500985245,999.195341407598,1360.54541992437,661,0,-661
"23","1991-11",0.0309258111603948,1224.6787700351,2821.04915434628,1098,0,-1098
"24","1991-12",0.0309049961465994,1524.54020510271,3980.0695593131,1273,0,-1273
"25","1992-01",0.0308730410869054,1643.09908308008,4479.96445690508,1281,0,-1281
"26","1992-02",0.0308524403861604,1382.65807806521,3559.61860092189,959,0,-959
"27","1992-03",0.030839741680801,1245.32653209487,2731.4394892561,814,0,-814
"28","1992-04",0.030832819766361,1127.63915879584,2264.17320704876,547,0,-547
"29","1992-05",0.0308354596836338,924.198391611998,1457.85833048535,315,5,-310
"30","1992-06",0.030846510390208,900.960240644815,1023.87187747442,142,19,-123
"31","1992-07",0.0308673618875484,893.283706057147,766.46468581277,87,29,-58
"32","1992-08",0.0308943569645724,929.025409878809,658.889370300514,100,68,-32
"33","1992-09",0.0309334197741605,896.791199722421,852.292840642052,253,5,-248
"34","1992-10",0.0309830570761573,1020.54197741456,1303.0961910002,553,0,-553
"35","1992-11",0.0310455470669301,1135.01427496051,2530.49202425774,1106,0,-1106
"36","1992-12",0.0311205320202364,1595.07080778317,4256.46434599994,1481,0,-1481
"37","1993-01",0.0312051154555732,1778.56107428628,5052.628030757,1501,0,-1501
"38","1993-02",0.0312866018106436,1466.92790014658,4235.63110035412,1371,0,-1371
"39","1993-03",0.0313623242827742,1428.51143675442,3893.18821139123,981,0,-981
"40","1993-04",0.0314287818537859,1213.22136177225,2738.98629098821,720,0,-720
"41","1993-05",0.031488407046997,1002.74964676528,1901.80200289591,373,0,-373
"42","1993-06",0.0315399262766461,942.367499892781,1188.24273381719,254,9,-245
"43","1993-07",0.0315842672564694,930.435836538628,858.507950730954,129,27,-102
"44","1993-08",0.0316202262150201,964.556032122381,684.082917099054,99,39,-60
"45","1993-09",0.0316513227831698,902.451709358178,889.148744608445,347,1,-346
"46","1993-10",0.0316768145660176,1067.68320749533,1497.97862555236,674,0,-674
"47","1993-11",0.0317002266570781,1280.47041511676,2756.72944575538,1169,0,-1169
"48","1993-12",0.0317191814408977,1655.4388645483,4035.94274288532,1234,0,-1234
"49","1994-01",0.0317324153917256,1566.44882526607,4306.0394554662,1224,0,-1224
"50","1994-02",0.0317505428708999,1445.71908245335,4164.65533216385,1224,0,-1224
"51","1994-03",0.0317659593187451,1355.93113572196,3186.6621526146,871,0,-871
"52","1994-04",0.0317755170684127,1155.81669308964,2602.68275613623,652,0,-652
"53","1994-05",0.0317891946165509,949.15225828485,1512.38063204321,270,1,-269
"54","1994-06",0.0317996977886868,904.32258823802,815.708749665104,93,54,-39
"55","1994-07",0.0318093051908963,946.287255742143,638.987852215932,35,99,64
"56","1994-08",0.0318181716641009,972.631212492565,594.458931778352,22,125,103
"57","1994-09",0.0318265073552023,908.94979340469,769.582391017899,204,12,-192
"58","1994-10",0.0318361116457279,1060.06472503183,1528.73583404018,652,0,-652
"59","1994-11",0.0318488927217163,1261.37054070223,2792.48426853294,1077,0,-1077
"60","1994-12",0.0318632503661869,1610.61150782074,3898.23829361021,1167,0,-1167
"61","1995-01",0.0318784303472812,1604.21718469668,4696.60519127228,1283,0,-1283
"62","1995-02",0.0319171549148433,1349.0988180227,3447.94600688386,984,0,-984
"63","1995-03",0.0319782850460212,1401.89133212707,3347.64644419951,969,0,-969
"64","1995-04",0.0320573307890516,1211.30849127933,2763.43358791181,769,0,-769
"65","1995-05",0.0321604603134508,1068.93892946013,2315.75382035787,576,0,-576
"66","1995-06",0.0322823261758178,1051.27706695656,1566.85588079506,233,14,-219
"67","1995-07",0.0324244414203509,948.428753866017,797.959754975583,59,85,26
"68","1995-08",0.0325883809367345,994.206386073812,622.865250389328,33,144,111
"69","1995-09",0.0327718491049055,961.74237322671,829.237641528011,299,26,-273
"70","1995-10",0.0329776152953752,1141.27961943129,1402.72040736054,684,0,-684
"71","1995-11",0.0332106171456221,1298.53476574931,2581.76358298912,890,0,-890
"72","1995-12",0.0334692353177763,1561.65779279216,3590.59151218626,1190,0,-1190
"73","1996-01",0.0337522054173932,1641.04428484711,4590.10728603189,1427,0,-1427
"74","1996-02",0.0339502672864797,1610.322636292,4990.87095982253,1137,0,-1137
"75","1996-03",0.0340613955750429,1463.61430775906,3582.04651668784,1112,0,-1112
"76","1996-04",0.0340847112094395,1241.08653755503,2962.27151911616,678,0,-678
"77","1996-05",0.0340241476370227,1093.9914164691,2113.65659732468,483,0,-483
"78","1996-06",0.0338764972967685,1077.27028332003,1168.96748940689,105,37,-68
"79","1996-07",0.0336437724348016,1008.80840355262,625.657287212907,14,115,101
"80","1996-08",0.0333233876240439,974.95141967676,607.211957470394,43,87,44
"81","1996-09",0.0329185964041229,968.845945430614,843.108578419501,315,10,-305
"82","1996-10",0.0324308691764183,1117.91429862268,2490.27406816794,660,0,-660
"83","1996-11",0.0318588400776969,1323.22869115085,3056.18127810996,1026,0,-1026
"84","1996-12",0.031207901631409,1642.25877259351,3996.46130007956,1291,0,-1291
"85","1997-01",0.0304733475327053,1841.47416318417,5160.01420689161,1401,0,-1401
"86","1997-02",0.0300371827443522,1494.61896327976,3822.54378434254,1141,0,-1141
"87","1997-03",0.0298971829610699,1433.38988229903,3555.07252092319,918,0,-918
"88","1997-04",0.0300520347989019,1212.58963754994,2435.99878469908,855,0,-855
"89","1997-05",0.0305052241264641,1139.54866585222,2477.40796986532,417,0,-417
"90","1997-06",0.0312539876074535,934.708211251799,910.610330711906,103,26,-77
"91","1997-07",0.0322990717539725,961.581946556289,676.54087491947,54,106,52
"92","1997-08",0.0336369235254217,1041.36065665734,561.680444397036,48,79,31
"93","1997-09",0.0352722334880126,960.095228389938,733.358160533066,205,22,-183
"94","1997-10",0.0372056136805042,1100.3569298618,1413.50711026486,616,0,-616
"95","1997-11",0.0394383698228249,1252.01307775109,2700.19033687275,1025,0,-1025
"96","1997-12",0.0419706136016331,1681.42490964703,5350.92295780811,1328,0,-1328
"97","1998-01",0.0447968290629598,1726.22304543985,4982.92739571168,1270,0,-1270
"98","1998-02",0.0473551182608511,1515.88684653432,3996.24215763186,1022,0,-1022
"99","1998-03",0.0496411082876723,1440.85706057549,3795.25406486859,1084,0,-1084
"100","1998-04",0.0516458883394734,1238.36350213705,2925.63551977486,697,0,-697
"101","1998-05",0.0533778612556428,1030.82408715077,1682.92467038162,383,0,-383
"102","1998-06",0.054836016742195,965.00285494268,1197.87105303295,300,4,-296
"103","1998-07",0.0560209823411719,911.261674024822,790.505789321356,5,162,157
"104","1998-08",0.0569301296548089,1119.61993944558,703.765719954716,24,99,75
"105","1998-09",0.0575694723144702,1011.65015959776,711.096422438813,145,58,-87
"106","1998-10",0.0579384581843892,1270.42373327489,1774.57396134633,628,0,-628
"107","1998-11",0.0580386819878465,1244.32217669286,2789.76406684285,875,0,-875
"108","1998-12",0.0578715088357586,1619.39993238231,3764.16584824608,1285,0,-1285
"109","1999-01",0.0574274083068111,1791.08755978216,4566.305467646,1192,0,-1192
"110","1999-02",0.0570340129897902,1478.49126232288,3939.22737789495,960,0,-960
"111","1999-03",0.0566783286638118,1456.13172217776,3106.07956686281,879,0,-879
"112","1999-04",0.0563522490009375,1210.18172036437,2893.50603855445,789,0,-789
"113","1999-05",0.0560635679610112,1215.67568980113,2580.39886946318,482,0,-482
"114","1999-06",0.0558113638066273,995.235742302793,1165.46161759886,184,16,-168
"115","1999-07",0.0555977006719976,1026.75939037777,671.423485125527,26,137,111
"116","1999-08",0.0554218301476652,1138.02136222202,529.982576143661,28,104,76
"117","1999-09",0.05528733017635,1018.39225085706,1096.02430275904,352,1,-351
"118","1999-10",0.0551939989603117,1142.87388295253,1635.45714021996,561,0,-561
"119","1999-11",0.055146868052023,1146.2105873031,2052.51770933951,723,0,-723
"120","1999-12",0.0551438362595314,1582.29652838033,3550.23152536868,1168,0,-1168
"121","2000-01",0.0551773831612609,1712.36152980004,3778.1149495047,1211,0,-1211
"122","2000-02",0.055249871971391,1439.43085766038,3759.59931186272,985,0,-985
"123","2000-03",0.0553510173792069,1358.74952502317,3216.92238681937,904,0,-904
"124","2000-04",0.0554732324842604,1262.27726323141,2729.98547771956,624,0,-624
"125","2000-05",0.0556331083718914,1025.05707619135,1492.24380294903,346,1,-345
"126","2000-06",0.0558180874817419,1028.77039440168,880.384355299455,157,28,-129
"127","2000-07",0.0560268424452241,1062.42092997134,672.668317936757,13,176,163
"128","2000-08",0.0562683280371095,1159.19243397704,645.45940421266,20,160,140
"129","2000-09",0.0565377295672177,1057.2887443113,855.809833897893,292,23,-269
"130","2000-10",0.0568388252761613,1120.34831700406,1647.46172397957,623,0,-623
"131","2000-11",0.057175843809329,1328.65168016343,2888.85126071764,1321,0,-1321
"132","2000-12",0.0575441546642108,1777.60945979714,4611.48655436811,1415,0,-1415
"133","2001-01",0.0579508943485755,1824.34510026064,4118.89293193357,1357,0,-1357
"134","2001-02",0.0583253921933873,1559.59376157538,4082.89757942228,1253,0,-1253
"135","2001-03",0.0586621930931518,1576.83303589335,2436.71708945967,966,0,-966
"136","2001-04",0.0589595555721085,1216.4193354584,2566.27054441671,648,0,-648
"137","2001-05",0.0592214669087757,1089.51792107372,1352.16589509125,364,4,-360
"138","2001-06",0.0594419525024041,1020.9624652518,972.537577915542,144,71,-73
"139","2001-07",0.0596257502405491,1169.57502908365,532.136786955656,6,197,191
"140","2001-08",0.0597694751092211,1238.67570094301,552.122712780813,13,157,144
"141","2001-09",0.0598732157026894,997.060490227061,605.431398082713,184,29,-155
"142","2001-10",0.0599551224545469,1185.73268555714,1598.68262481058,613,0,-613
"143","2001-11",0.0599924790093836,1234.19562149654,2319.89369843765,867,0,-867
"144","2001-12",0.0599956717980688,1550.92693866992,3339.86479682149,1302,0,-1302
"145","2002-01",0.0599653233279924,1796.24075401414,2970.37994788781,1322,0,-1322
"146","2002-02",0.0599485129006808,1572.41532472945,3124.42918732799,1136,0,-1136
"147","2002-03",0.0599498319966518,1662.06246508468,3203.25083292379,1215,0,-1215
"148","2002-04",0.0599594555450318,1357.72268682138,2326.23167643297,677,0,-677
"149","2002-05",0.0599792842015375,1135.82815756295,1537.50776273559,474,5,-469
"150","2002-06",0.0600085456700948,1079.62643003217,883.147288449983,107,82,-25
"151","2002-07",0.0600534118728464,1216.5327620822,2025.93204986701,4,228,224
"152","2002-08",0.060108911067699,1200.16136843806,455.298872745135,60,59,-1
"153","2002-09",0.0601749699693159,1050.63170861334,1122.07864875389,249,25,-224
"154","2002-10",0.0602565762859986,1146.75698451464,2258.5601768692,807,0,-807
"155","2002-11",0.0603553100197782,1361.78450464087,3959.60895810207,1009,0,-1009
"156","2002-12",0.0604753160966006,1592.1290280157,5643.4050572367,1187,0,-1187
"157","2003-01",0.0606088524068233,1771.89660082062,4153.95184331292,1095,0,-1095
"158","2003-02",0.0607540740292523,1535.35258713895,4042.22387856819,1206,0,-1206
"159","2003-03",0.0609001961723873,1587.78827405672,3488.6771858738,966,0,-966
"160","2003-04",0.0610422951839316,1330.79750901459,2049.13204249641,595,0,-595
"161","2003-05",0.0611808251394651,1117.61535139172,1545.56922421683,409,13,-396
"162","2003-06",0.0612954443832968,1280.63711653328,933.481393164029,205,8,-197
"163","2003-07",0.0614041369895371,1262.77621345151,564.566234781174,4,232,228
"164","2003-08",0.0615128445032277,1310.01051039387,535.510449424496,28,192,164
"165","2003-09",0.0616244720880544,1062.46553809049,885.262810668992,307,9,-298
"166","2003-10",0.0617361974260698,1105.09102466749,1428.08255740819,504,0,-504
"167","2003-11",0.0618501902830881,1508.31443698619,3100.15601830093,1132,0,-1132
"168","2003-12",0.0619715123204468,1614.77689472872,4042.65812081383,1194,0,-1194
"169","2004-01",0.0620949890558788,1848.68562188468,4726.83674605812,1331,0,-1331
"170","2004-02",0.0622212017233153,1724.11304756161,3986.71561571506,1167,0,-1167
"171","2004-03",0.0623432222484199,1532.84044954882,2857.23663259974,835,0,-835
"172","2004-04",0.0624523124582679,1173.17681588124,2136.45972220381,626,0,-626
"173","2004-05",0.0625543260415992,1172.96086557486,1377.26248504058,394,0,-394
"174","2004-06",0.0626580572121824,1054.6433418481,916.863513722525,193,14,-179
"175","2004-07",0.062756702076637,1209.97393211613,669.172235620152,52,105,53
"176","2004-08",0.0628488847158076,1110.03781691198,607.545412211568,96,56,-40
"177","2004-09",0.0629387117686369,1104.62245762586,834.323974792854,255,12,-243
"178","2004-10",0.0630233399386562,1134.10399338064,1630.5329461966,601,0,-601
"179","2004-11",0.0631132240260115,1370.47274369875,2888.72809627712,963,0,-963
"180","2004-12",0.0632037250234922,1755.35912036876,3832.12797528278,1147,0,-1147
"181","2005-01",0.0632914822890722,1847.90464054757,4234.31947324317,1232,0,-1232
"182","2005-02",0.0634628826018927,1589.07666562808,3673.43643746469,1024,0,-1024
"183","2005-03",0.0636977073185051,1575.46114552527,3155.82774379803,933,0,-933
"184","2005-04",0.063991766120501,1345.82555233021,2568.24966913878,679,0,-679
"185","2005-05",0.0643504911504904,1208.03286527974,1843.87235712127,459,1,-458
"186","2005-06",0.064781455550211,1185.34566548317,1007.28033321562,193,48,-145
"187","2005-07",0.0652763733979577,1326.96723423702,602.16403467152,20,197,177
"188","2005-08",0.0658395243650493,1261.85829342198,508.265868233924,59,67,8
"189","2005-09",0.0664679585802032,1156.83972753332,618.467543853321,237,24,-213
"190","2005-10",0.0671646949144111,1156.11489739712,1144.67419116613,559,0,-559
"191","2005-11",0.067942466978576,1292.23938524797,2053.4993551552,889,0,-889
"192","2005-12",0.0687785752998426,1955.21053950849,3949.16637062801,1331,0,-1331
"193","2006-01",0.0696869427395221,1864.3588061205,3886.84960683335,1070,0,-1070
"194","2006-02",0.0705305708732576,1747.24014710555,3666.65701092492,1138,0,-1138
"195","2006-03",0.071317518564659,1723.51452707309,3608.78943769571,998,0,-998
"196","2006-04",0.07203589293562,1363.41615722088,2402.1982103028,570,0,-570
"197","2006-05",0.0726927875370375,1201.41944807063,1512.64174263182,351,3,-348
"198","2006-06",0.0732795866608388,1189.00324516833,779.939314158939,45,60,15
"199","2006-07",0.0738001960890962,1273.97300980351,525.585814775239,2,236,234
"200","2006-08",0.0742606741995768,1362.26457503836,488.338120071078,34,104,70
"201","2006-09",0.0746518060672106,1051.14763254537,658.528675072805,338,0,-338
"202","2006-10",0.0749869469843688,1246.96095246825,1483.38426062137,673,0,-673
"203","2006-11",0.0752638326843711,1441.63849901101,2511.99863171942,908,0,-908
"204","2006-12",0.0754721725751386,1863.31801305961,3549.19351966059,1207,0,-1207
"205","2007-01",0.0756263730040985,2183.85577001001,4504.00590428562,1449,0,-1449
"206","2007-02",0.075811831291902,1812.34611051289,4258.76671147485,1057,0,-1057
"207","2007-03",0.0760247404801253,1682.53114920517,3236.27910191264,768,0,-768
"208","2007-04",0.0762543744978145,1325.90173102892,2303.65712147548,681,0,-681
"209","2007-05",0.076509778412194,1218.6746187911,1513.49205935658,359,0,-359
"210","2007-06",0.0767833692525828,1174.15008181207,913.249864607522,105,63,-42
"211","2007-07",0.0770751238208719,1383.29844126911,527.229950596863,0,239,239
"212","2007-08",0.0773890983555186,1391.92012517415,475.975471926669,15,143,128
"213","2007-09",0.0777260589384806,1151.32050758881,661.437654795112,232,26,-206
"214","2007-10",0.0780910679458166,1232.33155631471,1383.3826902869,565,0,-565
"215","2007-11",0.0784778407172925,1384.3066887659,2453.45925424885,872,0,-872
"216","2007-12",0.0788917074083552,1896.75091300658,3830.67195622445,1368,0,-1368
"217","2008-01",0.0793353515155254,2180.1068814481,4919.20940319708,1419,0,-1419
"218","2008-02",0.0797059501835874,1979.90272431426,4154.23011928787,1148,0,-1148
"219","2008-03",0.0799997588077558,1764.29592456049,3370.6475504666,986,0,-986
"220","2008-04",0.0802245105256016,1563.4230976055,2597.76631048643,778,0,-778
"221","2008-05",0.0803650614755328,1281.782754208,1677.74256514302,481,0,-481
"222","2008-06",0.0804327984198294,1192.56339485743,964.811854039605,180,14,-166
"223","2008-07",0.0804223923891993,1350.55912776842,552.93071328299,7,154,147
"224","2008-08",0.0803342018897408,1355.68208947429,521.261634688302,30,99,69
"225","2008-09",0.0801746473081798,1068.93533334811,775.707703171402,294,0,-294
"226","2008-10",0.0799452542093218,1227.43785262442,1516.57399283034,634,0,-634
"227","2008-11",0.0796454797555513,1357.99924679591,2477.36334292993,815,0,-815
"228","2008-12",0.079280830150635,2049.57327665502,3954.97295025171,1371,0,-1371
"229","2009-01",0.0788397908540769,2163.52606526132,4177.91831203072,1229,0,-1229
"230","2009-02",0.0783886435517083,1859.95504096184,3587.46750160601,1000,0,-1000
"231","2009-03",0.0779186323191451,1707.78866668387,3071.10539201143,983,0,-983
"232","2009-04",0.0774361702483799,1564.4617212314,2814.63787779572,744,0,-744
"233","2009-05",0.0769342749986411,1255.89571821588,1736.6844853527,386,2,-384
"234","2009-06",0.0764152915804833,1093.04332857154,884.395723877273,218,13,-205
"235","2009-07",0.0758795511944758,1287.75358542556,627.01967457488,36,67,31
"236","2009-08",0.0753291082177697,1145.03539135303,500.036768981502,70,51,-19
"237","2009-09",0.0747598577506243,1155.09045057953,570.616738690658,183,13,-170
"238","2009-10",0.0741808516435774,1292.00907384566,1595.34771288919,854,0,-854
"239","2009-11",0.0735927182824017,1540.72919398719,2462.24623079578,850,0,-850
"240","2009-12",0.073002969129718,1931.75593335834,3599.72321801452,1525,0,-1525
"241","2010-01",0.0723983638746407,2237.09394540505,4625.43765215102,1321,0,-1321
"242","2010-02",0.0718592214918901,1747.88855810735,3453.37108820171,1186,0,-1186
"243","2010-03",0.0713851685997466,1635.11993062552,2937.16069416407,884,0,-884
"244","2010-04",0.0709710528615165,1406.35885236623,2308.1832262166,694,0,-694
"245","2010-05",0.0706165702989796,1262.57052970628,1771.53449094285,559,2,-557
"246","2010-06",0.0703215459592586,1138.78581290444,961.750599320883,161,22,-139
"247","2010-07",0.0700800838382842,1246.58855098695,559.709949396204,35,118,83
"248","2010-08",0.06989226444454,1196.78319485966,442.493346393293,39,102,63
"249","2010-09",0.0697581885426928,1129.97677431504,571.958160182945,207,2,-205
"250","2010-10",0.0696806203911522,1097.60012326909,1160.719000867,492,0,-492
"251","2010-11",0.0696676661672895,1413.55451557564,2865.93006641267,1015,0,-1015
"252","2010-12",0.0697129165711923,1902.17685692797,3592.27274638797,1215,0,-1215
"253","2011-01",0.0698109194138387,2111.1043668452,4274.34576748261,1336,0,-1336
"254","2011-02",0.0698762579925057,1845.14111827011,3943.40482237228,1263,0,-1263
"255","2011-03",0.0699046880349318,1730.38378063063,2911.9805898332,939,0,-939
"256","2011-04",0.0698847381248247,1429.75236823725,2321.81876126185,752,0,-752
"257","2011-05",0.0698250350444843,1283.99390539098,1723.29397119501,570,0,-570
"258","2011-06",0.0697264433418739,1181.43876037875,724.48065901824,187,16,-171
"259","2011-07",0.0695797502882922,1225.43219256031,454.21858260276,2,166,164
"260","2011-08",0.0693926250876302,1315.8711824872,434.433953596745,4,145,141
"261","2011-09",0.0691605108712603,1147.87675516562,565.654277079976,195,4,-191
"262","2011-10",0.0688937029500082,1122.63997653816,1439.33685387352,557,1,-556
"263","2011-11",0.0685920871247816,1500.79220719518,2926.51047462325,983,0,-983
"264","2011-12",0.068251355142098,1880.6701464616,4022.51145888532,1313,0,-1313
"265","2012-01",0.0678708405620273,2003.52104783994,3695.05376251717,1155,0,-1155
"266","2012-02",0.0675374902907421,1779.85789998211,3640.61861648611,1158,0,-1158
"267","2012-03",0.0672337440155557,1606.01834729491,2339.76012641434,690,0,-690
"268","2012-04",0.0669677527491563,1220.86519848045,1526.04835110666,536,0,-536
"269","2012-05",0.0667390028490824,1115.63056798081,1070.65021605788,386,0,-386
"270","2012-06",0.0665410157446651,1192.92305270076,524.991318779138,70,99,29
"271","2012-07",0.0663766096880949,1347.03207256395,398.432874197485,0,242,242
"272","2012-08",0.0662431473170017,1317.96433210704,529.24462248081,17,126,109
"273","2012-09",0.0661415399867708,1115.8374039772,509.529583019902,177,15,-162
"274","2012-10",0.0660783909724968,1146.33506604408,1642.62370525496,655,0,-655
"275","2012-11",0.0660534924803065,1453.71563086836,2394.04661147393,828,0,-828
"276","2012-12",0.0660669290900953,1668.52788733849,3705.41098913842,1246,0,-1246
"277","2013-01",0.0661175197955013,2121.50256540353,4263.2352775804,1351,0,-1351
"278","2013-02",0.0661642606751252,1730.65224786235,3484.79521492506,1128,0,-1128
"279","2013-03",0.0661963118815267,1618.07266867042,2996.76251118103,961,0,-961
"280","2013-04",0.0662129893329235,1436.12299894267,2600.05691482663,844,0,-844
"281","2013-05",0.0662219627297825,1228.97713830931,1141.71987679203,381,2,-379
"282","2013-06",0.066208891256781,1051.00839973987,510.145562092746,96,54,-42
"283","2013-07",0.0661869077655325,1237.06853456087,419.316857485365,3,167,164
"284","2013-08",0.0661494112751928,1259.0249920138,409.747170394824,2,148,146
"285","2013-09",0.0660962644545057,1161.18165342438,641.813606546589,191,50,-141
"286","2013-10",0.0660333856790003,1238.0380561871,2015.67620326319,731,0,-731
"287","2013-11",0.0659599352974893,1443.15643758312,2885.47153904064,935,0,-935
"288","2013-12",0.0658829505864829,1969.32131815313,4412.65919199436,1383,0,-1383
"289","2014-01",0.0657930255721739,2000.07409996795,3860.29766993205,1245,0,-1245
"290","2014-02",0.065741085541043,1839.91678889179,3836.38485997987,1238,0,-1238
"291","2014-03",0.065724881252471,1648.31488081935,2930.52585097116,944,0,-944
"292","2014-04",0.0657402453372836,1379.29604883061,2078.99425356416,687,0,-687
"293","2014-05",0.0657858678965521,1242.93127740282,1319.7856217834,396,2,-394
"294","2014-06",0.0658640252046047,1035.59942220117,592.760717816111,186,5,-181
"295","2014-07",0.0659750274516625,1176.16125958398,494.470306427215,15,133,118
"296","2014-08",0.0661113000614646,1167.12543488132,454.63340520576,52,70,18
"297","2014-09",0.0662818397291144,1121.80493082986,727.801593119065,221,8,-213
"298","2014-10",0.0664865780411327,1138.38448147643,1388.83519928094,492,0,-492
"299","2014-11",0.0667275673129775,1416.7120382458,3448.4126160389,1054,0,-1054
"300","2014-12",0.0670069850003572,1819.29416077259,3894.42905903685,1192,0,-1192
"301","2015-01",0.0673210591403147,1924.40901741389,3698.28215845009,1202,0,-1202
"302","2015-02",0.0675804861731593,1563.42088613467,2739.62197582961,966,0,-966
"303","2015-03",0.0677734932330724,1608.45839241839,2212.21092408639,769,0,-769
"304","2015-04",0.0679002567969729,1234.91431416186,1668.34932823463,654,0,-654
"305","2015-05",0.0679626507428466,1115.67668474376,1372.87741010163,496,0,-496
"306","2015-06",0.0679612553375186,1195.19642951314,769.765050902749,47,55,8
"307","2015-07",0.0678934628001847,1198.71233151674,457.959011814883,32,93,61
"308","2015-08",0.0677595747265393,1231.1550347426,373.384550741257,44,104,60
"309","2015-09",0.067562907662688,1107.65861053663,562.750629406494,121,28,-93
"310","2015-10",0.0673020786359722,1110.47353047409,819.565356352569,444,0,-444
"311","2015-11",0.0669863307530309,1335.99767143293,2792.41567649621,989,0,-989
"312","2015-12",0.0666047534142634,1816.5970747953,4270.09266570695,1277,0,-1277
"313","2016-01",0.0661708493585205,2017.51041539398,3681.94967822339,1270,0,-1270
"314","2016-02",0.0658000292311673,1680.0616803409,2870.66070929843,944,0,-944
"315","2016-03",0.0654888972868822,1476.40358300274,2501.96402040561,857,0,-857
"316","2016-04",0.0652380942092043,1303.5677681469,1838.34034666065,627,0,-627
"317","2016-05",0.0650476981047026,1134.72729327858,1450.39094685862,460,0,-460
"318","2016-06",0.0649187067690993,1157.58467946469,552.685766697923,43,82,39
"319","2016-07",0.0648477658078972,1331.56805942726,434.532040022575,13,156,143
"320","2016-08",0.0648385179718142,1284.74724451993,487.559810450553,39,77,38
"321","2016-09",0.0648911436979052,1054.45010111177,665.060248132569,188,12,-176
"322","2016-10",0.0650044640783191,1163.9085022554,1370.91265339264,449,0,-449
"323","2016-11",0.065186779632895,1337.73494474024,2142.62123065201,757,0,-757
"324","2016-12",0.0654354145334012,1989.37824317579,4581.6479230133,1414,0,-1414
"325","2017-01",0.0657452911656515,2126.24285076676,4436.24963396095,1449,0,-1449
"326","2017-02",0.0660359699801067,1694.09649999365,3405.39745072584,970,0,-970
"327","2017-03",0.0662958768644592,1526.07651659987,2883.64320128844,745,0,-745
"328","2017-04",0.0665259777537892,1295.18460416903,1900.79264541711,669,0,-669
"329","2017-05",0.0667236386860676,1204.25696704311,1512.60301021981,425,0,-425
"330","2017-06",0.0668907951501694,1154.73419842339,707.274815687783,96,26,-70
"331","2017-07",0.0670246821354331,1387.91359200366,401.297142739759,1,203,202
"332","2017-08",0.0671268397547247,1180.48300310635,403.249164035069,27,57,30
"333","2017-09",0.0671994183075601,1052.92976687939,505.944903657362,275,35,-240
"334","2017-10",0.0672425180627025,1304.21134499058,1808.49333577301,660,0,-660
"335","2017-11",0.0672606087835304,1444.91958200845,2435.34272670458,827,0,-827
"336","2017-12",0.0672525208564975,1864.1320635948,3422.56231867619,1233,0,-1233
